CustomerID,Recency,Frequency,Value,RScore,FScore,VScore,RFV,Profile
12347.0,1,7,3314.73,3,3,3,9,Clientes VIP
12348.0,248,3,90.2,1,2,1,4,Clientes Churn
12349.0,18,1,999.15,3,1,3,7,Clientes Emergentes
12350.0,309,1,294.4,1,1,2,4,Clientes Churn
12352.0,35,7,1130.94,2,3,3,8,Clientes VIP
12353.0,203,1,29.300000000000004,1,1,1,3,Clientes Churn
12354.0,231,1,682.69,1,1,2,4,Clientes Churn
12355.0,213,1,219.0,1,1,1,3,Clientes Churn
12356.0,245,2,1086.56,1,1,3,5,Clientes Emergentes
12357.0,32,1,3315.41,2,1,3,6,Clientes Emergentes
12358.0,1,2,878.22,3,1,3,7,Clientes Emergentes
12359.0,57,4,3224.13,2,2,3,7,Clientes Emergentes
12360.0,51,3,1843.16,2,2,3,7,Clientes Emergentes
12361.0,286,1,174.9,1,1,1,3,Clientes Churn
12362.0,2,10,4098.94,3,3,3,9,Clientes VIP
12364.0,7,3,1106.28,3,2,3,8,Clientes VIP
12365.0,290,1,307.94,1,1,2,4,Clientes Churn
12367.0,3,1,138.3,3,1,1,5,Clientes Emergentes
12370.0,50,4,2602.41,2,2,3,7,Clientes Emergentes
12371.0,59,1,1300.46,2,1,3,6,Clientes Emergentes
12372.0,71,3,938.34,2,2,3,7,Clientes Emergentes
12373.0,310,1,299.1,1,1,2,4,Clientes Churn
12374.0,24,1,531.73,3,1,2,6,Clientes Emergentes
12375.0,10,2,283.3,3,1,2,6,Clientes Emergentes
12377.0,314,2,1472.52,1,1,3,5,Clientes Emergentes
12378.0,129,1,3396.64,1,1,3,5,Clientes Emergentes
12379.0,81,2,736.44,2,1,2,5,Clientes Emergentes
12380.0,21,4,1738.25,3,2,3,8,Clientes VIP
12381.0,4,5,1253.46,3,2,3,8,Clientes VIP
12383.0,184,5,1211.84,1,2,3,6,Clientes Emergentes
12384.0,28,2,286.32,2,1,2,5,Clientes Emergentes
12386.0,366,1,215.7,1,1,1,3,Clientes Churn
12388.0,15,6,2466.7000000000003,3,3,3,9,Clientes VIP
12390.0,79,1,407.74,2,1,2,5,Clientes Emergentes
12391.0,21,1,428.11,3,1,2,6,Clientes Emergentes
12393.0,71,4,1193.5,2,2,3,7,Clientes Emergentes
12394.0,216,1,331.18,1,1,2,4,Clientes Churn
12395.0,18,12,1844.57,3,3,3,9,Clientes VIP
12397.0,35,2,1720.01,2,1,3,6,Clientes Emergentes
12398.0,45,1,1349.44,2,1,3,6,Clientes Emergentes
12399.0,118,4,729.15,1,2,2,5,Clientes Emergentes
12401.0,302,1,32.85,1,1,1,3,Clientes Churn
12402.0,322,1,195.6,1,1,1,3,Clientes Churn
12403.0,49,1,92.9,2,1,1,4,Clientes Churn
12405.0,148,1,1104.8700000000001,1,1,3,5,Clientes Emergentes
12406.0,21,2,2871.78,3,1,3,7,Clientes Emergentes
12407.0,49,5,1085.01,2,2,3,7,Clientes Emergentes
12408.0,32,5,1869.47,2,2,3,7,Clientes Emergentes
12409.0,78,3,1646.79,2,2,3,7,Clientes Emergentes
12410.0,308,1,274.23,1,1,1,3,Clientes Churn
12412.0,74,3,1115.04,2,2,3,7,Clientes Emergentes
12413.0,66,3,545.2,2,2,2,6,Clientes Emergentes
12414.0,216,3,343.65,1,2,2,5,Clientes Emergentes
12415.0,24,11,3756.06,3,3,3,9,Clientes VIP
12417.0,2,9,2151.75,3,3,3,9,Clientes VIP
12418.0,112,1,418.16,1,1,2,4,Clientes Churn
12420.0,63,1,380.3,2,1,2,5,Clientes Emergentes
12421.0,15,4,607.57,3,2,2,7,Clientes Emergentes
12422.0,95,3,645.3100000000001,1,2,2,5,Clientes Emergentes
12423.0,0,8,1535.61,3,3,3,9,Clientes VIP
12424.0,162,2,703.72,1,1,2,4,Clientes Churn
12425.0,77,1,538.14,2,1,2,5,Clientes Emergentes
12426.0,194,1,446.08,1,1,2,4,Clientes Churn
12427.0,21,3,425.62,3,2,2,7,Clientes Emergentes
12428.0,25,8,4830.43,2,3,3,8,Clientes VIP
12429.0,8,4,2313.04,3,2,3,8,Clientes VIP
12430.0,42,1,168.6,2,1,1,4,Clientes Churn
12431.0,59,13,3933.55,2,3,3,8,Clientes VIP
12432.0,42,4,1909.68,2,2,3,7,Clientes Emergentes
12433.0,0,7,7947.37,3,3,3,9,Clientes VIP
12434.0,84,2,624.84,2,1,2,5,Clientes Emergentes
12435.0,267,1,78.0,1,1,1,3,Clientes Churn
12436.0,99,1,429.01000000000005,1,1,2,4,Clientes Churn
12437.0,1,18,2760.54,3,3,3,9,Clientes VIP
12438.0,13,2,1753.1200000000001,3,1,3,7,Clientes Emergentes
12441.0,366,1,155.55,1,1,1,3,Clientes Churn
12442.0,2,1,144.06,3,1,1,5,Clientes Emergentes
12444.0,20,5,2382.56,3,2,3,8,Clientes VIP
12445.0,21,1,77.4,3,1,1,5,Clientes Emergentes
12446.0,57,1,734.36,2,1,2,5,Clientes Emergentes
12447.0,242,1,379.78999999999996,1,1,2,4,Clientes Churn
12448.0,43,1,283.95,2,1,2,5,Clientes Emergentes
12449.0,21,4,2733.84,3,2,3,8,Clientes VIP
12450.0,155,2,131.88,1,1,1,3,Clientes Churn
12451.0,10,5,5878.31,3,2,3,8,Clientes VIP
12452.0,16,1,287.67,3,1,2,6,Clientes Emergentes
12453.0,133,1,707.09,1,1,2,4,Clientes Churn
12454.0,55,1,66.4,2,1,1,4,Clientes Churn
12455.0,72,5,1201.8600000000001,2,2,3,7,Clientes Emergentes
12456.0,43,3,1663.24,2,2,3,7,Clientes Emergentes
12457.0,85,2,958.93,2,1,3,6,Clientes Emergentes
12458.0,70,2,612.38,2,1,2,5,Clientes Emergentes
12461.0,154,1,419.08,1,1,2,4,Clientes Churn
12462.0,18,2,657.8,3,1,2,6,Clientes Emergentes
12463.0,52,4,1155.38,2,2,3,7,Clientes Emergentes
12464.0,149,4,76.5,1,2,1,4,Clientes Churn
12465.0,16,2,621.49,3,1,2,6,Clientes Emergentes
12468.0,187,2,575.99,1,1,2,4,Clientes Churn
12471.0,1,26,8738.78,3,3,3,9,Clientes VIP
12472.0,31,7,5052.03,2,3,3,8,Clientes VIP
12473.0,53,3,2229.45,2,2,3,7,Clientes Emergentes
12474.0,16,18,6166.9,3,3,3,9,Clientes VIP
12475.0,53,1,561.9399999999999,2,1,2,5,Clientes Emergentes
12476.0,15,10,3530.83,3,3,3,9,Clientes VIP
12477.0,22,6,7057.34,3,3,3,9,Clientes VIP
12478.0,3,1,479.59000000000003,3,1,2,6,Clientes Emergentes
12479.0,10,1,426.35,3,1,2,6,Clientes Emergentes
12480.0,27,4,2266.94,2,2,3,7,Clientes Emergentes
12481.0,22,10,3462.2,3,3,3,9,Clientes VIP
12483.0,16,7,1486.54,3,3,3,9,Clientes VIP
12484.0,34,4,3336.98,2,2,3,7,Clientes Emergentes
12488.0,9,3,952.1600000000001,3,2,3,8,Clientes VIP
12489.0,335,1,191.43,1,1,1,3,Clientes Churn
12490.0,4,10,4227.11,3,3,3,9,Clientes VIP
12491.0,38,1,350.75,2,1,2,5,Clientes Emergentes
12492.0,62,2,227.21,2,1,1,4,Clientes Churn
12493.0,165,2,332.91,1,1,2,4,Clientes Churn
12494.0,15,7,951.75,3,3,3,9,Clientes VIP
12497.0,81,1,20.4,2,1,1,4,Clientes Churn
12498.0,20,3,349.70000000000005,3,2,2,7,Clientes Emergentes
12500.0,49,7,497.89,2,3,2,7,Clientes Emergentes
12501.0,336,1,1866.66,1,1,3,5,Clientes Emergentes
12502.0,95,5,1511.32,1,2,3,6,Clientes Emergentes
12504.0,29,1,60.0,2,1,1,4,Clientes Churn
12506.0,232,1,57.6,1,1,1,3,Clientes Churn
12507.0,155,2,388.75,1,1,2,4,Clientes Churn
12508.0,25,2,398.27,2,1,2,5,Clientes Emergentes
12509.0,283,1,124.5,1,1,1,3,Clientes Churn
12510.0,142,2,620.05,1,1,2,4,Clientes Churn
12512.0,65,2,130.07999999999998,2,1,1,4,Clientes Churn
12513.0,112,1,520.04,1,1,2,4,Clientes Churn
12514.0,266,1,779.68,1,1,2,4,Clientes Churn
12515.0,352,1,190.8,1,1,1,3,Clientes Churn
12516.0,77,2,270.48,2,1,1,4,Clientes Churn
12517.0,27,4,2198.09,2,2,3,7,Clientes Emergentes
12518.0,0,5,1750.09,3,2,3,8,Clientes VIP
12519.0,63,1,252.84,2,1,1,4,Clientes Churn
12520.0,78,5,2061.56,2,2,3,7,Clientes Emergentes
12521.0,142,1,499.03,1,1,2,4,Clientes Churn
12522.0,38,2,152.72,2,1,1,4,Clientes Churn
12523.0,18,11,1277.91,3,3,3,9,Clientes VIP
12524.0,8,8,1719.21,3,3,3,9,Clientes VIP
12526.0,0,3,1074.46,3,2,3,8,Clientes VIP
12527.0,81,3,296.71000000000004,2,2,2,6,Clientes Emergentes
12528.0,8,6,1121.63,3,3,3,9,Clientes VIP
12530.0,59,4,1051.42,2,2,3,7,Clientes Emergentes
12531.0,14,1,95.27,3,1,1,5,Clientes Emergentes
12532.0,29,1,297.33000000000004,2,1,2,5,Clientes Emergentes
12534.0,130,1,828.73,1,1,3,5,Clientes Emergentes
12535.0,91,2,577.85,1,1,2,4,Clientes Churn
12536.0,58,1,3659.97,2,1,3,6,Clientes Emergentes
12538.0,28,1,258.75,2,1,1,4,Clientes Churn
12539.0,21,4,4141.6,3,2,3,8,Clientes VIP
12540.0,19,17,7967.64,3,3,3,9,Clientes VIP
12541.0,29,3,721.38,2,2,2,6,Clientes Emergentes
12544.0,35,1,284.9,2,1,2,5,Clientes Emergentes
12545.0,74,2,698.8,2,1,2,5,Clientes Emergentes
12546.0,46,2,969.58,2,1,3,6,Clientes Emergentes
12547.0,197,2,151.79999999999998,1,1,1,3,Clientes Churn
12548.0,165,1,67.19999999999999,1,1,1,3,Clientes Churn
12550.0,78,1,748.88,2,1,2,5,Clientes Emergentes
12551.0,357,1,168.0,1,1,1,3,Clientes Churn
12552.0,39,1,165.47,2,1,1,4,Clientes Churn
12553.0,7,10,2933.7,3,3,3,9,Clientes VIP
12556.0,49,2,517.81,2,1,2,5,Clientes Emergentes
12558.0,7,1,195.08,3,1,1,5,Clientes Emergentes
12559.0,319,1,301.41,1,1,2,4,Clientes Churn
12560.0,4,2,1746.16,3,1,3,7,Clientes Emergentes
12561.0,302,1,207.05,1,1,1,3,Clientes Churn
12562.0,7,7,2701.7400000000002,3,3,3,9,Clientes VIP
12564.0,260,1,336.15,1,1,2,4,Clientes Churn
12565.0,288,1,145.92,1,1,1,3,Clientes Churn
12566.0,85,1,222.13,2,1,1,4,Clientes Churn
12567.0,22,10,6673.58,3,3,3,9,Clientes VIP
12569.0,1,28,2704.69,3,3,3,9,Clientes VIP
12571.0,39,2,489.37,2,1,2,5,Clientes Emergentes
12572.0,8,2,650.87,3,1,2,6,Clientes Emergentes
12573.0,226,1,150.59,1,1,1,3,Clientes Churn
12574.0,315,1,162.55,1,1,1,3,Clientes Churn
12576.0,35,5,1225.31,2,2,3,7,Clientes Emergentes
12577.0,34,3,570.65,2,2,2,6,Clientes Emergentes
12578.0,20,2,2242.96,3,1,3,7,Clientes Emergentes
12579.0,77,1,329.12,2,1,2,5,Clientes Emergentes
12580.0,246,1,379.7,1,1,2,4,Clientes Churn
12581.0,39,1,169.76,2,1,1,4,Clientes Churn
12582.0,238,2,313.92,1,1,2,4,Clientes Churn
12583.0,2,15,5267.89,3,3,3,9,Clientes VIP
12584.0,3,8,1100.6000000000001,3,3,3,9,Clientes VIP
12585.0,233,2,1212.95,1,1,3,5,Clientes Emergentes
12586.0,16,1,186.54000000000002,3,1,1,5,Clientes Emergentes
12587.0,7,1,104.0,3,1,1,5,Clientes Emergentes
12588.0,38,1,79.65,2,1,1,4,Clientes Churn
12589.0,28,2,417.28,2,1,2,5,Clientes Emergentes
12590.0,210,1,877.26,1,1,3,5,Clientes Emergentes
12591.0,316,1,323.1,1,1,2,4,Clientes Churn
12592.0,91,2,350.6,1,1,2,4,Clientes Churn
12593.0,108,3,382.09999999999997,1,2,2,5,Clientes Emergentes
12594.0,46,8,2743.43,2,3,3,8,Clientes VIP
12596.0,50,2,288.27,2,1,2,5,Clientes Emergentes
12597.0,18,4,2544.07,3,2,3,8,Clientes VIP
12598.0,9,7,2103.43,3,3,3,9,Clientes VIP
12599.0,28,7,764.38,2,3,2,7,Clientes Emergentes
12600.0,28,9,1996.22,2,3,3,8,Clientes VIP
12601.0,189,5,371.51,1,2,2,5,Clientes Emergentes
12602.0,58,1,129.22,2,1,1,4,Clientes Churn
12604.0,78,2,236.18,2,1,1,4,Clientes Churn
12607.0,59,1,1490.26,2,1,3,6,Clientes Emergentes
12609.0,77,3,846.11,2,2,3,7,Clientes Emergentes
12610.0,22,4,1479.6399999999999,3,2,3,8,Clientes VIP
12611.0,51,1,924.52,2,1,3,6,Clientes Emergentes
12612.0,73,1,654.0,2,1,2,5,Clientes Emergentes
12613.0,56,4,2886.4,2,2,3,7,Clientes Emergentes
12614.0,277,1,218.15,1,1,1,3,Clientes Churn
12615.0,1,4,1552.99,3,2,3,8,Clientes VIP
12616.0,94,2,386.79999999999995,1,1,2,4,Clientes Churn
12617.0,28,1,335.63,2,1,2,5,Clientes Emergentes
12618.0,21,1,121.41,3,1,1,5,Clientes Emergentes
12619.0,15,8,681.02,3,3,2,8,Clientes VIP
12620.0,14,3,1100.1399999999999,3,2,3,8,Clientes VIP
12621.0,1,19,7699.9800000000005,3,3,3,9,Clientes VIP
12622.0,231,1,123.85,1,1,1,3,Clientes Churn
12623.0,275,1,269.1,1,1,1,3,Clientes Churn
12624.0,105,2,492.78,1,1,2,4,Clientes Churn
12625.0,211,2,1625.82,1,1,3,5,Clientes Emergentes
12626.0,22,9,4945.49,3,3,3,9,Clientes VIP
12627.0,10,6,3675.3,3,3,3,9,Clientes VIP
12628.0,3,3,665.46,3,2,2,7,Clientes Emergentes
12630.0,9,2,905.08,3,1,3,7,Clientes Emergentes
12631.0,56,1,396.0,2,1,2,5,Clientes Emergentes
12633.0,58,4,1379.94,2,2,3,7,Clientes Emergentes
12635.0,89,2,1357.69,1,1,3,5,Clientes Emergentes
12637.0,66,8,5075.84,2,3,3,8,Clientes VIP
12638.0,32,1,498.25,2,1,2,5,Clientes Emergentes
12639.0,238,1,325.3,1,1,2,4,Clientes Churn
12640.0,23,3,609.53,3,2,2,7,Clientes Emergentes
12641.0,114,1,128.9,1,1,1,3,Clientes Churn
12642.0,24,3,743.77,3,2,2,7,Clientes Emergentes
12643.0,220,2,73.28,1,1,1,3,Clientes Churn
12644.0,129,1,417.12,1,1,2,4,Clientes Churn
12645.0,33,4,1406.18,2,2,3,7,Clientes Emergentes
12646.0,4,2,838.16,3,1,3,7,Clientes Emergentes
12647.0,21,12,1843.87,3,3,3,9,Clientes VIP
12648.0,154,1,255.3,1,1,1,3,Clientes Churn
12649.0,106,3,513.0500000000001,1,2,2,5,Clientes Emergentes
12650.0,2,1,242.44000000000003,3,1,1,5,Clientes Emergentes
12651.0,334,1,114.0,1,1,1,3,Clientes Churn
12652.0,330,1,732.28,1,1,2,4,Clientes Churn
12653.0,148,2,752.81,1,1,2,4,Clientes Churn
12654.0,10,5,499.33,3,2,2,7,Clientes Emergentes
12656.0,16,5,1873.35,3,2,3,8,Clientes VIP
12657.0,10,3,623.0,3,2,2,7,Clientes Emergentes
12658.0,18,1,535.4,3,1,2,6,Clientes Emergentes
12659.0,29,1,45.6,2,1,1,4,Clientes Churn
12660.0,10,1,203.7,3,1,1,5,Clientes Emergentes
12662.0,0,11,3289.4300000000003,3,3,3,9,Clientes VIP
12664.0,58,4,406.8,2,2,2,6,Clientes Emergentes
12665.0,324,1,45.0,1,1,1,3,Clientes Churn
12667.0,57,1,410.23,2,1,2,5,Clientes Emergentes
12668.0,11,4,2666.0,3,2,3,8,Clientes VIP
12669.0,150,2,1319.92,1,1,3,5,Clientes Emergentes
12670.0,9,5,2087.47,3,2,3,8,Clientes VIP
12672.0,329,1,162.29999999999998,1,1,1,3,Clientes Churn
12673.0,4,2,504.62,3,1,2,6,Clientes Emergentes
12674.0,38,4,1289.54,2,2,3,7,Clientes Emergentes
12676.0,24,6,1031.39,3,3,3,9,Clientes VIP
12678.0,42,8,1359.8,2,3,3,8,Clientes VIP
12679.0,283,1,639.86,1,1,2,4,Clientes Churn
12680.0,0,4,736.97,3,2,2,7,Clientes Emergentes
12681.0,14,21,9584.4,3,3,3,9,Clientes VIP
12682.0,3,30,8437.94,3,3,3,9,Clientes VIP
12683.0,3,14,5146.41,3,3,3,9,Clientes VIP
12684.0,7,6,1646.19,3,3,3,9,Clientes VIP
12685.0,27,6,2437.65,2,3,3,8,Clientes VIP
12686.0,371,1,71.14,1,1,1,3,Clientes Churn
12688.0,113,1,2770.04,1,1,3,5,Clientes Emergentes
12689.0,25,2,1020.21,2,1,3,6,Clientes Emergentes
12690.0,205,1,265.11,1,1,1,3,Clientes Churn
12691.0,57,4,678.2,2,2,2,6,Clientes Emergentes
12693.0,126,4,476.51,1,2,2,5,Clientes Emergentes
12694.0,69,2,447.62,2,1,2,5,Clientes Emergentes
12695.0,6,4,342.56,3,2,2,7,Clientes Emergentes
12697.0,28,3,676.71,2,2,2,6,Clientes Emergentes
12700.0,7,4,3888.64,3,2,3,8,Clientes VIP
12701.0,79,2,652.45,2,1,2,5,Clientes Emergentes
12702.0,19,1,201.0,3,1,1,5,Clientes Emergentes
12703.0,70,1,265.55,2,1,1,4,Clientes Churn
12704.0,6,8,1180.98,3,3,3,9,Clientes VIP
12705.0,14,8,5154.4,3,3,3,9,Clientes VIP
12707.0,291,1,417.52000000000004,1,1,2,4,Clientes Churn
12708.0,29,10,2117.96,2,3,3,8,Clientes VIP
12709.0,14,14,4615.32,3,3,3,9,Clientes VIP
12710.0,96,3,909.8199999999999,1,2,3,6,Clientes Emergentes
12712.0,28,13,2586.98,2,3,3,8,Clientes VIP
12713.0,0,1,722.85,3,1,2,6,Clientes Emergentes
12714.0,8,5,3621.0299999999997,3,2,3,8,Clientes VIP
12715.0,105,1,273.86,1,1,1,3,Clientes Churn
12716.0,3,2,912.91,3,1,3,7,Clientes Emergentes
12717.0,150,2,774.03,1,1,2,4,Clientes Churn
12718.0,70,1,182.35,2,1,1,4,Clientes Churn
12719.0,4,2,498.55,3,1,2,6,Clientes Emergentes
12720.0,2,25,4424.39,3,3,3,9,Clientes VIP
12721.0,31,6,2108.19,2,3,3,8,Clientes VIP
12722.0,114,2,726.1,1,1,2,4,Clientes Churn
12723.0,3,4,580.33,3,2,2,7,Clientes Emergentes
12724.0,4,4,923.41,3,2,3,8,Clientes VIP
12725.0,370,1,371.8,1,1,2,4,Clientes Churn
12726.0,27,7,1550.1,2,3,3,8,Clientes VIP
12727.0,10,7,2461.52,3,3,3,9,Clientes VIP
12728.0,70,4,565.33,2,2,2,6,Clientes Emergentes
12729.0,113,1,360.71000000000004,1,1,2,4,Clientes Churn
12731.0,23,10,7116.69,3,3,3,9,Clientes VIP
12732.0,179,1,178.26000000000002,1,1,1,3,Clientes Churn
12733.0,233,1,276.85,1,1,1,3,Clientes Churn
12734.0,352,1,110.39999999999999,1,1,1,3,Clientes Churn
12735.0,314,2,375.07,1,1,2,4,Clientes Churn
12736.0,332,1,93.6,1,1,1,3,Clientes Churn
12738.0,371,1,110.4,1,1,1,3,Clientes Churn
12739.0,98,1,516.0,1,1,2,4,Clientes Churn
12740.0,63,1,344.8,2,1,2,5,Clientes Emergentes
12744.0,55,4,4774.93,2,2,3,7,Clientes Emergentes
12747.0,1,11,2640.41,3,3,3,9,Clientes VIP
12748.0,0,196,21046.63,3,3,3,9,Clientes VIP
12749.0,3,5,2737.73,3,2,3,8,Clientes VIP
12750.0,128,1,184.98,1,1,1,3,Clientes Churn
12752.0,80,1,854.12,2,1,3,6,Clientes Emergentes
12753.0,22,6,1988.77,3,3,3,9,Clientes VIP
12754.0,276,2,61.62,1,1,1,3,Clientes Churn
12755.0,280,1,7.6,1,1,1,3,Clientes Churn
12756.0,86,1,50.879999999999995,2,1,1,4,Clientes Churn
12757.0,15,7,3194.0,3,3,3,9,Clientes VIP
12758.0,116,2,1468.59,1,1,3,5,Clientes Emergentes
12759.0,51,3,1279.09,2,2,3,7,Clientes Emergentes
12762.0,7,2,1211.3,3,1,3,7,Clientes Emergentes
12763.0,368,1,320.08,1,1,2,4,Clientes Churn
12764.0,316,1,952.88,1,1,3,5,Clientes Emergentes
12766.0,3,7,5713.12,3,3,3,9,Clientes VIP
12769.0,238,1,869.4,1,1,3,5,Clientes Emergentes
12772.0,59,1,615.3199999999999,2,1,2,5,Clientes Emergentes
12775.0,16,5,952.14,3,2,3,8,Clientes VIP
12778.0,19,6,492.49,3,3,2,8,Clientes VIP
12779.0,37,8,2523.53,2,3,3,8,Clientes VIP
12781.0,63,2,594.54,2,1,2,5,Clientes Emergentes
12782.0,4,5,1811.47,3,2,3,8,Clientes VIP
12783.0,1,4,1011.3000000000001,3,2,3,8,Clientes VIP
12784.0,14,1,497.07,3,1,2,6,Clientes Emergentes
12785.0,363,1,239.0,1,1,1,3,Clientes Churn
12787.0,9,3,356.26,3,2,2,7,Clientes Emergentes
12790.0,191,1,199.42000000000002,1,1,1,3,Clientes Churn
12792.0,256,1,329.59,1,1,2,4,Clientes Churn
12793.0,334,2,395.48,1,1,2,4,Clientes Churn
12794.0,52,2,795.51,2,1,2,5,Clientes Emergentes
12795.0,18,1,144.63,3,1,1,5,Clientes Emergentes
12797.0,365,1,206.13,1,1,1,3,Clientes Churn
12802.0,186,1,397.58,1,1,2,4,Clientes Churn
12808.0,36,3,445.7,2,2,2,6,Clientes Emergentes
12809.0,177,1,343.41,1,1,2,4,Clientes Churn
12811.0,261,2,416.55,1,1,2,4,Clientes Churn
12812.0,44,1,229.64000000000001,2,1,1,4,Clientes Churn
12815.0,147,2,687.66,1,1,2,4,Clientes Churn
12816.0,95,2,265.90000000000003,1,1,1,3,Clientes Churn
12817.0,280,1,126.03999999999999,1,1,1,3,Clientes Churn
12818.0,261,1,267.6,1,1,1,3,Clientes Churn
12820.0,2,4,923.62,3,2,3,8,Clientes VIP
12821.0,213,1,75.72,1,1,1,3,Clientes Churn
12822.0,70,2,743.28,2,1,2,5,Clientes Emergentes
12824.0,59,1,316.42,2,1,2,5,Clientes Emergentes
12826.0,2,7,1460.8,3,3,3,9,Clientes VIP
12827.0,5,3,430.15000000000003,3,2,2,7,Clientes Emergentes
12828.0,2,6,961.96,3,3,3,9,Clientes VIP
12829.0,336,1,28.5,1,1,1,3,Clientes Churn
12831.0,261,1,124.75,1,1,1,3,Clientes Churn
12832.0,31,2,366.53,2,1,2,5,Clientes Emergentes
12833.0,144,1,307.03000000000003,1,1,2,4,Clientes Churn
12834.0,282,1,201.08,1,1,1,3,Clientes Churn
12836.0,58,4,1622.6200000000001,2,2,3,7,Clientes Emergentes
12837.0,172,1,58.75,1,1,1,3,Clientes Churn
12838.0,33,2,586.48,2,1,2,5,Clientes Emergentes
12839.0,2,14,5115.12,3,3,3,9,Clientes VIP
12840.0,143,4,2726.77,1,2,3,6,Clientes Emergentes
12841.0,4,25,3339.54,3,3,3,9,Clientes VIP
12842.0,69,2,582.3100000000001,2,1,2,5,Clientes Emergentes
12843.0,159,7,1395.69,1,3,3,7,Clientes Emergentes
12844.0,28,2,325.96000000000004,2,1,2,5,Clientes Emergentes
12845.0,268,2,54.79,1,1,1,3,Clientes Churn
12847.0,21,1,668.14,3,1,2,6,Clientes Emergentes
12849.0,30,2,777.74,2,1,2,5,Clientes Emergentes
12851.0,96,1,108.28,1,1,1,3,Clientes Churn
12852.0,294,1,264.15000000000003,1,1,1,3,Clientes Churn
12853.0,134,5,1227.2,1,2,3,6,Clientes Emergentes
12854.0,78,3,1056.4,2,2,3,7,Clientes Emergentes
12855.0,372,1,38.1,1,1,1,3,Clientes Churn
12856.0,7,6,1969.18,3,3,3,9,Clientes VIP
12857.0,210,2,831.15,1,1,3,5,Clientes Emergentes
12863.0,51,1,109.2,2,1,1,4,Clientes Churn
12864.0,137,1,10.2,1,1,1,3,Clientes Churn
12865.0,25,2,1355.82,2,1,3,6,Clientes Emergentes
12866.0,282,1,344.92,1,1,2,4,Clientes Churn
12867.0,25,7,3664.77,2,3,3,8,Clientes VIP
12868.0,185,6,1534.71,1,3,3,7,Clientes Emergentes
12871.0,83,2,120.53999999999999,2,1,1,4,Clientes Churn
12872.0,326,2,507.12,1,1,2,4,Clientes Churn
12876.0,57,2,1100.82,2,1,3,6,Clientes Emergentes
12877.0,3,12,1413.31,3,3,3,9,Clientes VIP
12878.0,235,2,839.09,1,1,3,5,Clientes Emergentes
12879.0,44,3,220.66,2,2,1,5,Clientes Emergentes
12881.0,275,1,69.0,1,1,1,3,Clientes Churn
12882.0,8,2,995.4,3,1,3,7,Clientes Emergentes
12883.0,24,4,527.87,3,2,2,7,Clientes Emergentes
12884.0,87,1,107.25,2,1,1,4,Clientes Churn
12885.0,62,3,977.22,2,2,3,7,Clientes Emergentes
12886.0,67,2,1059.3600000000001,2,1,3,6,Clientes Emergentes
12888.0,213,2,187.92000000000002,1,1,1,3,Clientes Churn
12890.0,23,1,365.38,3,1,2,6,Clientes Emergentes
12893.0,30,1,188.14,2,1,1,4,Clientes Churn
12895.0,41,2,335.05,2,1,2,5,Clientes Emergentes
12897.0,204,2,100.50000000000001,1,1,1,3,Clientes Churn
12901.0,9,15,1162.35,3,3,3,9,Clientes VIP
12902.0,264,1,87.78,1,1,1,3,Clientes Churn
12904.0,17,2,351.73,3,1,2,6,Clientes Emergentes
12906.0,11,5,1108.02,3,2,3,8,Clientes VIP
12909.0,39,5,1022.43,2,2,3,7,Clientes Emergentes
12910.0,22,8,2297.02,3,3,3,9,Clientes VIP
12912.0,7,4,735.66,3,2,2,7,Clientes Emergentes
12913.0,4,5,1088.45,3,2,3,8,Clientes VIP
12915.0,148,2,201.05,1,1,1,3,Clientes Churn
12916.0,138,4,1821.5,1,2,3,6,Clientes Emergentes
12919.0,7,6,1159.21,3,3,3,9,Clientes VIP
12920.0,16,1,108.34,3,1,1,5,Clientes Emergentes
12921.0,8,37,13030.37,3,3,3,9,Clientes VIP
12922.0,160,1,377.3,1,1,2,4,Clientes Churn
12923.0,63,1,157.07,2,1,1,4,Clientes Churn
12924.0,87,4,644.2,2,2,2,6,Clientes Emergentes
12925.0,4,2,636.13,3,1,2,6,Clientes Emergentes
12928.0,34,5,1739.74,2,2,3,7,Clientes Emergentes
12929.0,311,1,70.95,1,1,1,3,Clientes Churn
12930.0,77,2,389.61,2,1,2,5,Clientes Emergentes
12931.0,66,2,48.160000000000004,2,1,1,4,Clientes Churn
12933.0,23,3,465.47,3,2,2,7,Clientes Emergentes
12935.0,1,7,1851.55,3,3,3,9,Clientes VIP
12936.0,16,3,911.9,3,2,3,8,Clientes VIP
12937.0,14,4,1233.1200000000001,3,2,3,8,Clientes VIP
12938.0,25,1,100.22,2,1,1,4,Clientes Churn
12939.0,334,1,81.36,1,1,1,3,Clientes Churn
12940.0,54,2,529.47,2,1,2,5,Clientes Emergentes
12942.0,130,3,505.0,1,2,2,5,Clientes Emergentes
12944.0,35,2,519.81,2,1,2,5,Clientes Emergentes
12945.0,287,1,264.25,1,1,1,3,Clientes Churn
12947.0,143,5,1269.59,1,2,3,6,Clientes Emergentes
12948.0,15,7,1892.3600000000001,3,3,3,9,Clientes VIP
12949.0,30,8,3639.92,2,3,3,8,Clientes VIP
12950.0,7,2,284.2,3,1,2,6,Clientes Emergentes
12951.0,8,6,979.12,3,3,3,9,Clientes VIP
12952.0,5,4,1058.26,3,2,3,8,Clientes VIP
12953.0,9,1,192.45000000000002,3,1,1,5,Clientes Emergentes
12955.0,0,11,3260.2599999999998,3,3,3,9,Clientes VIP
12956.0,305,1,74.67,1,1,1,3,Clientes Churn
12957.0,9,8,3547.04,3,3,3,9,Clientes VIP
12962.0,6,2,240.89000000000001,3,1,1,5,Clientes Emergentes
12963.0,7,8,1664.06,3,3,3,9,Clientes VIP
12965.0,88,1,597.71,2,1,2,5,Clientes Emergentes
12966.0,9,1,147.68,3,1,1,5,Clientes Emergentes
12967.0,357,2,452.2,1,1,2,4,Clientes Churn
12968.0,111,1,126.0,1,1,1,3,Clientes Churn
12970.0,6,4,356.82,3,2,2,7,Clientes Emergentes
12971.0,3,78,5357.93,3,3,3,9,Clientes VIP
12974.0,197,1,77.15,1,1,1,3,Clientes Churn
12976.0,211,1,303.6,1,1,2,4,Clientes Churn
12977.0,155,1,10.74,1,1,1,3,Clientes Churn
12981.0,29,2,372.21999999999997,2,1,2,5,Clientes Emergentes
12982.0,242,1,376.5,1,1,2,4,Clientes Churn
12984.0,18,1,97.5,3,1,1,5,Clientes Emergentes
12985.0,0,2,1033.52,3,1,3,7,Clientes Emergentes
12987.0,73,2,392.45,2,1,2,5,Clientes Emergentes
12988.0,291,1,330.67,1,1,2,4,Clientes Churn
12989.0,2,10,1277.23,3,3,3,9,Clientes VIP
12990.0,30,3,351.0,2,2,2,6,Clientes Emergentes
12991.0,22,2,461.26,3,1,2,6,Clientes Emergentes
12993.0,22,4,414.76,3,2,2,7,Clientes Emergentes
12994.0,3,3,782.52,3,2,2,7,Clientes Emergentes
12997.0,21,4,880.09,3,2,3,8,Clientes VIP
12999.0,204,2,273.78,1,1,1,3,Clientes Churn
13000.0,259,2,382.16,1,1,2,4,Clientes Churn
13001.0,3,13,5093.2,3,3,3,9,Clientes VIP
13002.0,317,1,110.99999999999999,1,1,1,3,Clientes Churn
13003.0,150,2,89.05000000000001,1,1,1,3,Clientes Churn
13004.0,11,17,5139.96,3,3,3,9,Clientes VIP
13005.0,173,2,323.3,1,1,2,4,Clientes Churn
13006.0,55,1,11.52,2,1,1,4,Clientes Churn
13008.0,322,1,229.46999999999997,1,1,1,3,Clientes Churn
13011.0,371,1,50.550000000000004,1,1,1,3,Clientes Churn
13012.0,8,7,1431.15,3,3,3,9,Clientes VIP
13013.0,0,13,4146.400000000001,3,3,3,9,Clientes VIP
13014.0,10,9,1499.03,3,3,3,9,Clientes VIP
13015.0,52,5,2648.93,2,2,3,7,Clientes Emergentes
13016.0,72,3,709.34,2,2,2,6,Clientes Emergentes
13018.0,15,28,6530.12,3,3,3,9,Clientes VIP
13021.0,3,9,1855.96,3,3,3,9,Clientes VIP
13023.0,63,2,439.86,2,1,2,5,Clientes Emergentes
13026.0,0,4,341.88,3,2,2,7,Clientes Emergentes
13028.0,22,2,613.4399999999999,3,1,2,6,Clientes Emergentes
13029.0,30,2,116.5,2,1,1,4,Clientes Churn
13030.0,10,2,561.88,3,1,2,6,Clientes Emergentes
13032.0,51,2,735.93,2,1,2,5,Clientes Emergentes
13033.0,356,1,190.55,1,1,1,3,Clientes Churn
13034.0,54,2,627.82,2,1,2,5,Clientes Emergentes
13035.0,73,2,349.20000000000005,2,1,2,5,Clientes Emergentes
13037.0,137,3,693.37,1,2,2,5,Clientes Emergentes
13038.0,79,3,891.46,2,2,3,7,Clientes Emergentes
13040.0,8,2,676.99,3,1,2,6,Clientes Emergentes
13043.0,272,1,139.7,1,1,1,3,Clientes Churn
13044.0,290,1,391.72,1,1,2,4,Clientes Churn
13045.0,98,1,305.28000000000003,1,1,2,4,Clientes Churn
13046.0,30,2,419.11,2,1,2,5,Clientes Emergentes
13047.0,31,10,2646.26,2,3,3,8,Clientes VIP
13048.0,13,4,1810.41,3,2,3,8,Clientes VIP
13049.0,63,2,433.68,2,1,2,5,Clientes Emergentes
13050.0,14,17,4707.73,3,3,3,9,Clientes VIP
13052.0,211,1,197.65,1,1,1,3,Clientes Churn
13055.0,77,3,1104.06,2,2,3,7,Clientes Emergentes
13058.0,24,3,261.45000000000005,3,2,1,6,Clientes Emergentes
13059.0,249,1,85.65,1,1,1,3,Clientes Churn
13060.0,253,1,243.93,1,1,1,3,Clientes Churn
13061.0,71,1,200.31,2,1,1,4,Clientes Churn
13062.0,190,1,65.69999999999999,1,1,1,3,Clientes Churn
13064.0,12,4,893.12,3,2,3,8,Clientes VIP
13065.0,372,1,138.41,1,1,1,3,Clientes Churn
13066.0,23,2,372.75,3,1,2,6,Clientes Emergentes
13067.0,81,1,91.61,2,1,1,4,Clientes Churn
13069.0,0,24,3449.82,3,3,3,9,Clientes VIP
13070.0,191,1,228.8,1,1,1,3,Clientes Churn
13072.0,266,1,177.15,1,1,1,3,Clientes Churn
13075.0,129,1,477.21,1,1,2,4,Clientes Churn
13077.0,0,4,638.46,3,2,2,7,Clientes Emergentes
13078.0,2,26,7392.89,3,3,3,9,Clientes VIP
13079.0,3,5,220.10000000000002,3,2,1,6,Clientes Emergentes
13080.0,178,1,58.08,1,1,1,3,Clientes Churn
13081.0,11,10,17925.53,3,3,3,9,Clientes VIP
13082.0,125,8,1177.36,1,3,3,7,Clientes Emergentes
13083.0,3,2,235.8,3,1,1,5,Clientes Emergentes
13085.0,157,2,217.68,1,1,1,3,Clientes Churn
13089.0,3,80,36411.63,3,3,3,9,Clientes VIP
13090.0,8,13,3737.11,3,3,3,9,Clientes VIP
13091.0,27,1,281.08,2,1,2,5,Clientes Emergentes
13092.0,70,5,266.61,2,2,1,5,Clientes Emergentes
13093.0,275,8,3429.4700000000003,1,3,3,7,Clientes Emergentes
13094.0,205,2,106.2,1,1,1,3,Clientes Churn
13095.0,70,1,60.48,2,1,1,4,Clientes Churn
13097.0,32,10,4091.88,2,3,3,8,Clientes VIP
13098.0,0,27,9869.38,3,3,3,9,Clientes VIP
13101.0,233,1,65.5,1,1,1,3,Clientes Churn
13102.0,0,24,4998.69,3,3,3,9,Clientes VIP
13103.0,39,1,141.94,2,1,1,4,Clientes Churn
13104.0,2,4,570.48,3,2,2,7,Clientes Emergentes
13106.0,132,1,76.5,1,1,1,3,Clientes Churn
13107.0,43,4,1092.0,2,2,3,7,Clientes Emergentes
13108.0,372,1,95.3,1,1,1,3,Clientes Churn
13109.0,59,2,763.2,2,1,2,5,Clientes Emergentes
13110.0,30,7,971.22,2,3,3,8,Clientes VIP
13113.0,0,24,3286.14,3,3,3,9,Clientes VIP
13115.0,11,4,2029.06,3,2,3,8,Clientes VIP
13116.0,137,1,291.29,1,1,2,4,Clientes Churn
13117.0,21,8,840.7,3,3,3,9,Clientes VIP
13118.0,19,5,1125.96,3,2,3,8,Clientes VIP
13120.0,238,1,30.599999999999998,1,1,1,3,Clientes Churn
13121.0,268,1,260.36,1,1,1,3,Clientes Churn
13122.0,239,1,821.1,1,1,2,4,Clientes Churn
13124.0,89,3,2904.58,1,2,3,6,Clientes Emergentes
13126.0,4,8,1783.57,3,3,3,9,Clientes VIP
13127.0,77,1,259.17,2,1,1,4,Clientes Churn
13130.0,93,1,64.0,1,1,1,3,Clientes Churn
13131.0,22,3,604.3,3,2,2,7,Clientes Emergentes
13132.0,261,1,60.3,1,1,1,3,Clientes Churn
13133.0,273,2,79.95,1,1,1,3,Clientes Churn
13134.0,85,4,1392.14,2,2,3,7,Clientes Emergentes
13136.0,55,5,2408.51,2,2,3,7,Clientes Emergentes
13137.0,10,8,3553.89,3,3,3,9,Clientes VIP
13138.0,21,6,946.49,3,3,3,9,Clientes VIP
13139.0,15,7,2473.04,3,3,3,9,Clientes VIP
13140.0,107,3,349.92,1,2,2,5,Clientes Emergentes
13141.0,84,5,2260.53,2,2,3,7,Clientes Emergentes
13142.0,18,1,215.92,3,1,1,5,Clientes Emergentes
13144.0,332,1,47.2,1,1,1,3,Clientes Churn
13145.0,39,3,297.6,2,2,2,6,Clientes Emergentes
13146.0,25,1,228.91,2,1,1,4,Clientes Churn
13147.0,42,2,237.60000000000002,2,1,1,4,Clientes Churn
13148.0,28,11,2709.2200000000003,2,3,3,8,Clientes VIP
13149.0,13,4,1210.68,3,2,3,8,Clientes VIP
13151.0,295,1,773.27,1,1,2,4,Clientes Churn
13153.0,5,1,140.46,3,1,1,5,Clientes Emergentes
13155.0,32,4,843.0600000000001,2,2,3,7,Clientes Emergentes
13157.0,48,4,1447.98,2,2,3,7,Clientes Emergentes
13158.0,94,4,1193.5,1,2,3,6,Clientes Emergentes
13159.0,8,4,1215.79,3,2,3,8,Clientes VIP
13160.0,21,1,75.89999999999999,3,1,1,5,Clientes Emergentes
13161.0,312,1,95.75,1,1,1,3,Clientes Churn
13162.0,121,4,1156.15,1,2,3,6,Clientes Emergentes
13165.0,45,2,349.28,2,1,2,5,Clientes Emergentes
13166.0,282,1,349.6,1,1,2,4,Clientes Churn
13167.0,18,4,482.15999999999997,3,2,2,7,Clientes Emergentes
13168.0,35,4,1108.39,2,2,3,7,Clientes Emergentes
13169.0,63,2,355.1,2,1,2,5,Clientes Emergentes
13170.0,26,1,109.17,2,1,1,4,Clientes Churn
13171.0,21,3,261.51,3,2,1,6,Clientes Emergentes
13173.0,3,2,340.21,3,1,2,6,Clientes Emergentes
13174.0,15,3,2072.7400000000002,3,2,3,8,Clientes VIP
13176.0,45,1,348.78,2,1,2,5,Clientes Emergentes
13177.0,64,1,282.45,2,1,2,5,Clientes Emergentes
13178.0,25,11,4569.75,2,3,3,8,Clientes VIP
13182.0,44,1,121.18,2,1,1,4,Clientes Churn
13183.0,7,9,1126.63,3,3,3,9,Clientes VIP
13184.0,14,10,1429.11,3,3,3,9,Clientes VIP
13185.0,267,1,71.4,1,1,1,3,Clientes Churn
13186.0,39,3,1362.02,2,2,3,7,Clientes Emergentes
13187.0,336,1,154.02,1,1,1,3,Clientes Churn
13188.0,10,1,99.60000000000001,3,1,1,5,Clientes Emergentes
13189.0,18,2,167.28,3,1,1,5,Clientes Emergentes
13192.0,94,2,859.14,1,1,3,5,Clientes Emergentes
13193.0,60,1,100.92999999999999,2,1,1,4,Clientes Churn
13194.0,135,1,60.7,1,1,1,3,Clientes Churn
13196.0,10,4,1704.03,3,2,3,8,Clientes VIP
13198.0,9,6,3181.55,3,3,3,9,Clientes VIP
13199.0,7,19,2420.0,3,3,3,9,Clientes VIP
13200.0,21,3,607.27,3,2,2,7,Clientes Emergentes
13203.0,9,4,798.68,3,2,2,7,Clientes Emergentes
13207.0,14,2,250.26000000000002,3,1,1,5,Clientes Emergentes
13208.0,58,6,1075.8,2,3,3,8,Clientes VIP
13209.0,29,7,4798.16,2,3,3,8,Clientes VIP
13210.0,93,1,293.0,1,1,2,4,Clientes Churn
13211.0,9,3,483.42,3,2,2,7,Clientes Emergentes
13212.0,19,3,528.73,3,2,2,7,Clientes Emergentes
13213.0,56,5,1197.28,2,2,3,7,Clientes Emergentes
13216.0,267,1,10.5,1,1,1,3,Clientes Churn
13217.0,121,1,52.02,1,1,1,3,Clientes Churn
13218.0,126,1,56.76,1,1,1,3,Clientes Churn
13220.0,77,4,506.04,2,2,2,6,Clientes Emergentes
13221.0,239,2,570.71,1,1,2,4,Clientes Churn
13223.0,199,1,62.4,1,1,1,3,Clientes Churn
13224.0,59,2,1807.92,2,1,3,6,Clientes Emergentes
13226.0,272,1,85.51,1,1,1,3,Clientes Churn
13227.0,201,1,257.7,1,1,1,3,Clientes Churn
13229.0,225,1,123.15,1,1,1,3,Clientes Churn
13230.0,3,14,2087.79,3,3,3,9,Clientes VIP
13232.0,12,7,982.16,3,3,3,9,Clientes VIP
13233.0,73,2,477.2,2,1,2,5,Clientes Emergentes
13235.0,211,1,870.57,1,1,3,5,Clientes Emergentes
13236.0,24,2,592.33,3,1,2,6,Clientes Emergentes
13238.0,22,3,493.68,3,2,2,7,Clientes Emergentes
13239.0,261,1,292.12,1,1,2,4,Clientes Churn
13240.0,95,4,616.7,1,2,2,5,Clientes Emergentes
13242.0,111,3,270.40000000000003,1,2,1,4,Clientes Churn
13243.0,202,1,480.02000000000004,1,1,2,4,Clientes Churn
13244.0,92,1,94.79,1,1,1,3,Clientes Churn
13245.0,50,1,259.85,2,1,1,4,Clientes Churn
13246.0,17,6,844.31,3,3,3,9,Clientes VIP
13247.0,17,4,474.72,3,2,2,7,Clientes Emergentes
13248.0,124,2,434.21,1,1,2,4,Clientes Churn
13249.0,92,1,82.23,1,1,1,3,Clientes Churn
13253.0,156,2,380.15999999999997,1,1,2,4,Clientes Churn
13255.0,8,2,198.46,3,1,1,5,Clientes Emergentes
13258.0,11,3,509.48,3,2,2,7,Clientes Emergentes
13259.0,61,1,258.32,2,1,1,4,Clientes Churn
13260.0,60,1,82.32000000000001,2,1,1,4,Clientes Churn
13261.0,268,2,670.5,1,1,2,4,Clientes Churn
13262.0,262,1,132.29,1,1,1,3,Clientes Churn
13263.0,0,34,6723.0,3,3,3,9,Clientes VIP
13265.0,52,5,1247.52,2,2,3,7,Clientes Emergentes
13266.0,10,12,2290.61,3,3,3,9,Clientes VIP
13267.0,2,18,3704.69,3,3,3,9,Clientes VIP
13268.0,17,10,2847.0,3,3,3,9,Clientes VIP
13269.0,0,15,4353.11,3,3,3,9,Clientes VIP
13271.0,36,1,217.38,2,1,1,4,Clientes Churn
13272.0,30,2,205.66000000000003,2,1,1,4,Clientes Churn
13273.0,112,1,128.54,1,1,1,3,Clientes Churn
13276.0,63,2,462.98,2,1,2,5,Clientes Emergentes
13277.0,15,3,159.4,3,2,1,6,Clientes Emergentes
13278.0,40,1,459.86,2,1,2,5,Clientes Emergentes
13279.0,77,1,137.75,2,1,1,4,Clientes Churn
13280.0,121,3,739.85,1,2,2,5,Clientes Emergentes
13282.0,17,3,726.94,3,2,2,7,Clientes Emergentes
13283.0,59,2,93.66,2,1,1,4,Clientes Churn
13284.0,330,1,148.74,1,1,1,3,Clientes Churn
13285.0,22,4,2566.02,3,2,3,8,Clientes VIP
13291.0,155,1,338.41,1,1,2,4,Clientes Churn
13292.0,38,2,418.45,2,1,2,5,Clientes Emergentes
13294.0,189,2,726.39,1,1,2,4,Clientes Churn
13295.0,359,1,168.3,1,1,1,3,Clientes Churn
13296.0,136,1,53.4,1,1,1,3,Clientes Churn
13297.0,7,4,1641.59,3,2,3,8,Clientes VIP
13298.0,0,1,90.0,3,1,1,5,Clientes Emergentes
13299.0,267,1,82.80000000000001,1,1,1,3,Clientes Churn
13300.0,168,1,371.89,1,1,2,4,Clientes Churn
13301.0,103,4,507.74,1,2,2,5,Clientes Emergentes
13304.0,350,1,244.85000000000002,1,1,1,3,Clientes Churn
13305.0,3,10,1000.21,3,3,3,9,Clientes VIP
13307.0,119,1,15.0,1,1,1,3,Clientes Churn
13308.0,22,3,1092.43,3,2,3,8,Clientes VIP
13309.0,6,5,1389.78,3,2,3,8,Clientes VIP
13310.0,27,3,1015.73,2,2,3,7,Clientes Emergentes
13311.0,3,2,408.82000000000005,3,1,2,6,Clientes Emergentes
13313.0,21,5,1475.1200000000001,3,2,3,8,Clientes VIP
13314.0,1,3,666.69,3,2,2,7,Clientes Emergentes
13316.0,36,4,580.49,2,2,2,6,Clientes Emergentes
13317.0,65,6,1781.8300000000002,2,3,3,8,Clientes VIP
13318.0,0,3,379.53999999999996,3,2,2,7,Clientes Emergentes
13319.0,4,26,9305.39,3,3,3,9,Clientes VIP
13320.0,77,4,1548.7,2,2,3,7,Clientes Emergentes
13321.0,85,1,259.04,2,1,1,4,Clientes Churn
13322.0,16,1,199.48000000000002,3,1,1,5,Clientes Emergentes
13323.0,2,5,583.85,3,2,2,7,Clientes Emergentes
13324.0,35,8,1036.95,2,3,3,8,Clientes VIP
13325.0,81,1,471.3,2,1,2,5,Clientes Emergentes
13327.0,38,8,2690.07,2,3,3,8,Clientes VIP
13328.0,315,1,235.68,1,1,1,3,Clientes Churn
13329.0,31,2,312.48,2,1,2,5,Clientes Emergentes
13330.0,92,3,961.38,1,2,3,6,Clientes Emergentes
13332.0,13,1,338.4,3,1,2,6,Clientes Emergentes
13334.0,81,3,3165.62,2,2,3,7,Clientes Emergentes
13336.0,76,1,752.8000000000001,2,1,2,5,Clientes Emergentes
13338.0,157,1,316.47,1,1,2,4,Clientes Churn
13339.0,200,1,664.42,1,1,2,4,Clientes Churn
13340.0,44,6,2161.56,2,3,3,8,Clientes VIP
13341.0,260,1,603.55,1,1,2,4,Clientes Churn
13343.0,177,1,290.93,1,1,2,4,Clientes Churn
13344.0,67,3,1716.32,2,2,3,7,Clientes Emergentes
13345.0,287,1,299.70000000000005,1,1,2,4,Clientes Churn
13347.0,69,1,148.79999999999998,2,1,1,4,Clientes Churn
13348.0,63,1,233.76,2,1,1,4,Clientes Churn
13349.0,10,1,197.32,3,1,1,5,Clientes Emergentes
13350.0,15,2,652.77,3,1,2,6,Clientes Emergentes
13351.0,65,1,323.94,2,1,2,5,Clientes Emergentes
13352.0,59,1,316.17999999999995,2,1,2,5,Clientes Emergentes
13354.0,70,1,684.91,2,1,2,5,Clientes Emergentes
13355.0,121,1,516.0,1,1,2,4,Clientes Churn
13356.0,79,1,548.59,2,1,2,5,Clientes Emergentes
13357.0,256,1,492.15,1,1,2,4,Clientes Churn
13358.0,268,1,304.71,1,1,2,4,Clientes Churn
13359.0,63,1,307.06,2,1,2,5,Clientes Emergentes
13362.0,8,4,2686.64,3,2,3,8,Clientes VIP
13363.0,17,2,834.89,3,1,3,7,Clientes Emergentes
13364.0,70,1,134.95999999999998,2,1,1,4,Clientes Churn
13365.0,33,2,1718.8700000000001,2,1,3,6,Clientes Emergentes
13368.0,256,2,430.18,1,1,2,4,Clientes Churn
13369.0,365,1,198.38000000000002,1,1,1,3,Clientes Churn
13370.0,371,1,604.75,1,1,2,4,Clientes Churn
13372.0,89,1,290.04,1,1,2,4,Clientes Churn
13373.0,60,3,2726.17,2,2,3,7,Clientes Emergentes
13375.0,88,1,607.1800000000001,2,1,2,5,Clientes Emergentes
13376.0,98,3,834.3100000000001,1,2,3,6,Clientes Emergentes
13379.0,25,3,521.36,2,2,2,6,Clientes Emergentes
13381.0,31,6,3045.75,2,3,3,8,Clientes VIP
13382.0,280,1,197.14000000000001,1,1,1,3,Clientes Churn
13384.0,30,7,2877.66,2,3,3,8,Clientes VIP
13385.0,329,1,403.07,1,1,2,4,Clientes Churn
13388.0,130,2,505.45,1,1,2,4,Clientes Churn
13389.0,10,3,700.66,3,2,2,7,Clientes Emergentes
13390.0,74,1,304.68,2,1,2,5,Clientes Emergentes
13394.0,1,8,1999.09,3,3,3,9,Clientes VIP
13395.0,184,1,251.28,1,1,1,3,Clientes Churn
13396.0,28,2,936.69,2,1,3,6,Clientes Emergentes
13397.0,72,4,1118.81,2,2,3,7,Clientes Emergentes
13398.0,191,1,383.57,1,1,2,4,Clientes Churn
13402.0,126,2,587.23,1,1,2,4,Clientes Churn
13403.0,17,1,30.0,3,1,1,5,Clientes Emergentes
13404.0,0,2,252.49,3,1,1,5,Clientes Emergentes
13405.0,73,3,363.351,2,2,2,6,Clientes Emergentes
13408.0,1,52,9337.800000000001,3,3,3,9,Clientes VIP
13410.0,23,4,588.34,3,2,2,7,Clientes Emergentes
13411.0,106,1,203.60000000000002,1,1,1,3,Clientes Churn
13414.0,133,2,568.5,1,1,2,4,Clientes Churn
13416.0,43,2,576.5,2,1,2,5,Clientes Emergentes
13417.0,4,2,290.48,3,1,2,6,Clientes Emergentes
13418.0,11,18,4699.71,3,3,3,9,Clientes VIP
13419.0,63,1,221.06,2,1,1,4,Clientes Churn
13420.0,149,2,87.6,1,1,1,3,Clientes Churn
13421.0,39,2,1575.29,2,1,3,6,Clientes Emergentes
13422.0,63,1,2292.0,2,1,3,6,Clientes Emergentes
13425.0,107,3,1057.45,1,2,3,6,Clientes Emergentes
13426.0,0,10,3007.02,3,3,3,9,Clientes VIP
13427.0,18,3,445.34,3,2,2,7,Clientes Emergentes
13428.0,9,1,176.57,3,1,1,5,Clientes Emergentes
13429.0,10,4,816.69,3,2,2,7,Clientes Emergentes
13430.0,18,2,574.25,3,1,2,6,Clientes Emergentes
13431.0,66,2,814.8,2,1,2,5,Clientes Emergentes
13434.0,73,2,179.04000000000002,2,1,1,4,Clientes Churn
13435.0,4,7,1894.06,3,3,3,9,Clientes VIP
13436.0,1,1,113.53999999999999,3,1,1,5,Clientes Emergentes
13437.0,13,7,2384.36,3,3,3,9,Clientes VIP
13439.0,254,1,273.27,1,1,1,3,Clientes Churn
13441.0,91,1,195.36,1,1,1,3,Clientes Churn
13447.0,22,3,1026.69,3,2,3,8,Clientes VIP
13448.0,16,6,3032.1800000000003,3,3,3,9,Clientes VIP
13449.0,23,1,291.88,3,1,2,6,Clientes Emergentes
13450.0,26,6,1272.48,2,3,3,8,Clientes VIP
13451.0,25,5,2627.85,2,2,3,7,Clientes Emergentes
13453.0,165,2,245.57999999999998,1,1,1,3,Clientes Churn
13455.0,24,2,660.19,3,1,2,6,Clientes Emergentes
13456.0,17,5,1180.1200000000001,3,2,3,8,Clientes VIP
13458.0,6,14,7396.57,3,3,3,9,Clientes VIP
13460.0,28,2,183.44,2,1,1,4,Clientes Churn
13461.0,38,3,329.8,2,2,2,6,Clientes Emergentes
13462.0,252,1,135.0,1,1,1,3,Clientes Churn
13464.0,57,1,606.73,2,1,2,5,Clientes Emergentes
13466.0,183,1,197.70000000000002,1,1,1,3,Clientes Churn
13467.0,10,2,871.8100000000001,3,1,3,7,Clientes Emergentes
13468.0,1,37,3762.89,3,3,3,9,Clientes VIP
13470.0,98,2,165.0,1,1,1,3,Clientes Churn
13471.0,0,4,2219.13,3,2,3,8,Clientes VIP
13473.0,60,2,326.96,2,1,2,5,Clientes Emergentes
13474.0,235,1,187.99,1,1,1,3,Clientes Churn
13475.0,190,4,1115.66,1,2,3,6,Clientes Emergentes
13476.0,178,2,697.67,1,1,2,4,Clientes Churn
13477.0,37,6,1249.8899999999999,2,3,3,8,Clientes VIP
13479.0,200,2,261.15,1,1,1,3,Clientes Churn
13481.0,45,5,1680.26,2,2,3,7,Clientes Emergentes
13482.0,231,1,184.64,1,1,1,3,Clientes Churn
13483.0,65,1,140.34,2,1,1,4,Clientes Churn
13484.0,240,1,202.5,1,1,1,3,Clientes Churn
13485.0,232,1,394.44,1,1,2,4,Clientes Churn
13486.0,77,3,999.55,2,2,3,7,Clientes Emergentes
13487.0,57,3,361.1,2,2,2,6,Clientes Emergentes
13488.0,16,13,6585.43,3,3,3,9,Clientes VIP
13489.0,104,3,175.44,1,2,1,4,Clientes Churn
13491.0,51,10,943.34,2,3,3,8,Clientes VIP
13492.0,135,3,729.24,1,2,2,5,Clientes Emergentes
13493.0,286,1,14.850000000000001,1,1,1,3,Clientes Churn
13494.0,311,1,296.1,1,1,2,4,Clientes Churn
13495.0,7,5,1716.07,3,2,3,8,Clientes VIP
13496.0,10,2,563.63,3,1,2,6,Clientes Emergentes
13497.0,282,2,348.05,1,1,2,4,Clientes Churn
13499.0,17,5,609.09,3,2,2,7,Clientes Emergentes
13500.0,22,3,1010.8,3,2,3,8,Clientes VIP
13501.0,287,1,844.72,1,1,3,5,Clientes Emergentes
13502.0,16,3,272.1,3,2,1,6,Clientes Emergentes
13503.0,70,1,192.95,2,1,1,4,Clientes Churn
13504.0,63,1,260.48,2,1,1,4,Clientes Churn
13505.0,72,4,3042.26,2,2,3,7,Clientes Emergentes
13506.0,315,2,379.45,1,1,2,4,Clientes Churn
13507.0,2,4,1991.61,3,2,3,8,Clientes VIP
13508.0,243,1,66.42,1,1,1,3,Clientes Churn
13509.0,8,5,662.6800000000001,3,2,2,7,Clientes Emergentes
13510.0,0,4,1565.02,3,2,3,8,Clientes VIP
13512.0,260,1,228.51000000000002,1,1,1,3,Clientes Churn
13513.0,126,1,132.6,1,1,1,3,Clientes Churn
13514.0,73,1,152.20000000000002,2,1,1,4,Clientes Churn
13515.0,72,4,833.82,2,2,3,7,Clientes Emergentes
13516.0,72,2,607.91,2,1,2,5,Clientes Emergentes
13517.0,59,3,1839.49,2,2,3,7,Clientes Emergentes
13518.0,85,1,567.72,2,1,2,5,Clientes Emergentes
13519.0,77,1,78.95,2,1,1,4,Clientes Churn
13520.0,58,6,1582.45,2,3,3,8,Clientes VIP
13521.0,0,3,1000.1,3,2,3,8,Clientes VIP
13522.0,29,1,125.80000000000001,2,1,1,4,Clientes Churn
13523.0,32,5,2181.58,2,2,3,7,Clientes Emergentes
13524.0,40,5,580.94,2,2,2,6,Clientes Emergentes
13525.0,14,1,90.0,3,1,1,5,Clientes Emergentes
13527.0,33,7,1906.0,2,3,3,8,Clientes VIP
13529.0,78,2,206.06,2,1,1,4,Clientes Churn
13531.0,204,2,357.7,1,1,2,4,Clientes Churn
13532.0,33,1,210.31,2,1,1,4,Clientes Churn
13533.0,182,3,246.94,1,2,1,4,Clientes Churn
13534.0,1,24,5186.38,3,3,3,9,Clientes VIP
13536.0,0,7,2455.51,3,3,3,9,Clientes VIP
13538.0,42,5,699.45,2,2,2,6,Clientes Emergentes
13539.0,85,3,446.52,2,2,2,6,Clientes Emergentes
13544.0,39,2,221.26,2,1,1,4,Clientes Churn
13546.0,11,3,553.29,3,2,2,7,Clientes Emergentes
13548.0,95,2,512.84,1,1,2,4,Clientes Churn
13549.0,25,7,793.85,2,3,2,7,Clientes Emergentes
13551.0,318,1,53.550000000000004,1,1,1,3,Clientes Churn
13552.0,65,12,2227.55,2,3,3,8,Clientes VIP
13555.0,73,4,2210.34,2,2,3,7,Clientes Emergentes
13557.0,27,2,524.06,2,1,2,5,Clientes Emergentes
13558.0,5,4,561.11,3,2,2,7,Clientes Emergentes
13560.0,6,1,174.37,3,1,1,5,Clientes Emergentes
13561.0,215,1,39.01,1,1,1,3,Clientes Churn
13562.0,81,3,1459.6100000000001,2,2,3,7,Clientes Emergentes
13563.0,83,2,375.13,2,1,2,5,Clientes Emergentes
13564.0,353,2,892.94,1,1,3,5,Clientes Emergentes
13565.0,18,2,240.22,3,1,1,5,Clientes Emergentes
13566.0,40,2,864.76,2,1,3,6,Clientes Emergentes
13568.0,172,1,175.0,1,1,1,3,Clientes Churn
13569.0,16,2,286.1,3,1,2,6,Clientes Emergentes
13570.0,242,1,211.64,1,1,1,3,Clientes Churn
13571.0,12,12,2017.27,3,3,3,9,Clientes VIP
13572.0,205,1,590.9300000000001,1,1,2,4,Clientes Churn
13573.0,49,2,238.11,2,1,1,4,Clientes Churn
13575.0,22,5,674.5699999999999,3,2,2,7,Clientes Emergentes
13576.0,9,17,1797.66,3,3,3,9,Clientes VIP
13577.0,24,4,1353.5,3,2,3,8,Clientes VIP
13579.0,14,2,321.29,3,1,2,6,Clientes Emergentes
13581.0,308,1,56.95,1,1,1,3,Clientes Churn
13583.0,155,1,691.05,1,1,2,4,Clientes Churn
13584.0,306,1,75.75,1,1,1,3,Clientes Churn
13587.0,63,1,168.0,2,1,1,4,Clientes Churn
13588.0,15,9,2331.81,3,3,3,9,Clientes VIP
13589.0,14,2,256.05,3,1,1,5,Clientes Emergentes
13590.0,10,6,1417.5,3,3,3,9,Clientes VIP
13591.0,64,3,809.58,2,2,2,6,Clientes Emergentes
13592.0,35,3,159.51,2,2,1,5,Clientes Emergentes
13593.0,107,5,1497.13,1,2,3,6,Clientes Emergentes
13594.0,52,1,396.97,2,1,2,5,Clientes Emergentes
13596.0,5,2,619.84,3,1,2,6,Clientes Emergentes
13598.0,46,1,134.07,2,1,1,4,Clientes Churn
13599.0,0,21,3840.66,3,3,3,9,Clientes VIP
13600.0,311,1,66.52,1,1,1,3,Clientes Churn
13601.0,44,2,663.08,2,1,2,5,Clientes Emergentes
13602.0,64,1,398.65000000000003,2,1,2,5,Clientes Emergentes
13603.0,25,1,129.44,2,1,1,4,Clientes Churn
13606.0,28,2,152.22,2,1,1,4,Clientes Churn
13607.0,39,1,565.5600000000001,2,1,2,5,Clientes Emergentes
13610.0,11,7,891.78,3,3,3,9,Clientes VIP
13611.0,88,3,974.1600000000001,2,2,3,7,Clientes Emergentes
13614.0,23,4,1076.8600000000001,3,2,3,8,Clientes VIP
13615.0,318,1,385.89,1,1,2,4,Clientes Churn
13617.0,39,3,444.04,2,2,2,6,Clientes Emergentes
13618.0,173,1,154.54,1,1,1,3,Clientes Churn
13621.0,116,1,209.85,1,1,1,3,Clientes Churn
13623.0,30,5,392.05,2,2,2,6,Clientes Emergentes
13626.0,252,1,241.32999999999998,1,1,1,3,Clientes Churn
13627.0,58,5,1203.83,2,2,3,7,Clientes Emergentes
13629.0,142,1,281.01,1,1,2,4,Clientes Churn
13630.0,4,7,866.94,3,3,3,9,Clientes VIP
13631.0,99,5,332.5,1,2,2,5,Clientes Emergentes
13632.0,24,5,1766.71,3,2,3,8,Clientes VIP
13634.0,32,5,1142.21,2,2,3,7,Clientes Emergentes
13635.0,67,1,1031.43,2,1,3,6,Clientes Emergentes
13636.0,36,5,720.83,2,2,2,6,Clientes Emergentes
13637.0,51,3,741.25,2,2,2,6,Clientes Emergentes
13638.0,15,1,97.14,3,1,1,5,Clientes Emergentes
13639.0,73,1,646.34,2,1,2,5,Clientes Emergentes
13642.0,215,1,268.55,1,1,1,3,Clientes Churn
13643.0,30,3,468.44,2,2,2,6,Clientes Emergentes
13644.0,15,4,1979.0900000000001,3,2,3,8,Clientes VIP
13645.0,119,1,30.599999999999998,1,1,1,3,Clientes Churn
13647.0,9,4,1164.52,3,2,3,8,Clientes VIP
13649.0,256,2,333.85,1,1,2,4,Clientes Churn
13650.0,16,6,1567.29,3,3,3,9,Clientes VIP
13651.0,39,1,63.3,2,1,1,4,Clientes Churn
13652.0,45,3,1003.64,2,2,3,7,Clientes Emergentes
13654.0,42,6,2261.97,2,3,3,8,Clientes VIP
13655.0,113,2,753.22,1,1,2,4,Clientes Churn
13656.0,164,2,319.79,1,1,2,4,Clientes Churn
13657.0,10,2,321.0,3,1,2,6,Clientes Emergentes
13658.0,9,5,1735.85,3,2,3,8,Clientes VIP
13659.0,205,2,1225.47,1,1,3,5,Clientes Emergentes
13662.0,85,3,663.56,2,2,2,6,Clientes Emergentes
13663.0,178,1,91.07,1,1,1,3,Clientes Churn
13666.0,59,3,67.65,2,2,1,5,Clientes Emergentes
13667.0,148,1,258.17,1,1,1,3,Clientes Churn
13668.0,2,21,4326.41,3,3,3,9,Clientes VIP
13669.0,50,2,160.2,2,1,1,4,Clientes Churn
13670.0,74,1,333.2,2,1,2,5,Clientes Emergentes
13672.0,300,2,186.39000000000001,1,1,1,3,Clientes Churn
13673.0,18,2,307.27,3,1,2,6,Clientes Emergentes
13675.0,150,2,473.38,1,1,2,4,Clientes Churn
13678.0,151,1,72.56,1,1,1,3,Clientes Churn
13680.0,0,4,2112.84,3,2,3,8,Clientes VIP
13681.0,17,4,796.0300000000001,3,2,2,7,Clientes Emergentes
13682.0,186,1,34.0,1,1,1,3,Clientes Churn
13684.0,285,1,67.23,1,1,1,3,Clientes Churn
13685.0,2,4,20.92,3,2,1,6,Clientes Emergentes
13686.0,182,1,72.0,1,1,1,3,Clientes Churn
13689.0,62,1,15.0,2,1,1,4,Clientes Churn
13690.0,58,1,81.60000000000001,2,1,1,4,Clientes Churn
13692.0,24,2,749.64,3,1,2,6,Clientes Emergentes
13694.0,3,19,2576.61,3,3,3,9,Clientes VIP
13695.0,30,13,1616.53,2,3,3,8,Clientes VIP
13697.0,38,1,151.29999999999998,2,1,1,4,Clientes Churn
13699.0,154,1,70.08000000000001,1,1,1,3,Clientes Churn
13700.0,25,10,1856.6200000000001,2,3,3,8,Clientes VIP
13704.0,4,9,1817.8,3,3,3,9,Clientes VIP
13705.0,7,3,492.78000000000003,3,2,2,7,Clientes Emergentes
13706.0,302,1,290.89,1,1,2,4,Clientes Churn
13707.0,266,2,581.36,1,1,2,4,Clientes Churn
13708.0,270,1,272.01,1,1,1,3,Clientes Churn
13709.0,3,13,4719.05,3,3,3,9,Clientes VIP
13710.0,31,1,94.56,2,1,1,4,Clientes Churn
13711.0,218,2,232.16000000000003,1,1,1,3,Clientes Churn
13712.0,246,1,88.2,1,1,1,3,Clientes Churn
13715.0,280,5,1018.2,1,2,3,6,Clientes Emergentes
13716.0,268,1,138.28,1,1,1,3,Clientes Churn
13717.0,31,6,1088.32,2,3,3,8,Clientes VIP
13718.0,245,2,242.4,1,1,1,3,Clientes Churn
13719.0,14,5,855.41,3,2,3,8,Clientes VIP
13720.0,116,4,685.8,1,2,2,5,Clientes Emergentes
13721.0,35,1,470.94,2,1,2,5,Clientes Emergentes
13722.0,131,3,2004.68,1,2,3,6,Clientes Emergentes
13723.0,216,1,150.10000000000002,1,1,1,3,Clientes Churn
13725.0,49,7,1203.52,2,3,3,8,Clientes VIP
13726.0,38,2,429.11999999999995,2,1,2,5,Clientes Emergentes
13727.0,28,2,285.78000000000003,2,1,2,5,Clientes Emergentes
13728.0,36,6,437.44,2,3,2,7,Clientes Emergentes
13730.0,135,2,522.55,1,1,2,4,Clientes Churn
13731.0,218,2,511.59000000000003,1,1,2,4,Clientes Churn
13732.0,27,1,491.86,2,1,2,5,Clientes Emergentes
13735.0,24,4,1970.99,3,2,3,8,Clientes VIP
13736.0,4,2,566.05,3,1,2,6,Clientes Emergentes
13737.0,199,1,185.65,1,1,1,3,Clientes Churn
13739.0,17,1,125.10000000000001,3,1,1,5,Clientes Emergentes
13740.0,240,1,234.71,1,1,1,3,Clientes Churn
13741.0,71,3,405.63,2,2,2,6,Clientes Emergentes
13742.0,16,12,1918.81,3,3,3,9,Clientes VIP
13743.0,2,7,805.1999999999999,3,3,2,8,Clientes VIP
13744.0,94,2,992.1,1,1,3,5,Clientes Emergentes
13745.0,161,1,241.35999999999999,1,1,1,3,Clientes Churn
13748.0,95,4,328.7,1,2,2,5,Clientes Emergentes
13750.0,53,3,243.68,2,2,1,5,Clientes Emergentes
13751.0,287,1,75.6,1,1,1,3,Clientes Churn
13752.0,123,6,723.74,1,3,2,6,Clientes Emergentes
13753.0,287,1,710.66,1,1,2,4,Clientes Churn
13754.0,151,2,129.6,1,1,1,3,Clientes Churn
13755.0,3,9,1657.3500000000001,3,3,3,9,Clientes VIP
13756.0,1,13,2850.44,3,3,3,9,Clientes VIP
13758.0,11,7,1955.39,3,3,3,9,Clientes VIP
13759.0,32,2,439.59000000000003,2,1,2,5,Clientes Emergentes
13760.0,53,2,286.79,2,1,2,5,Clientes Emergentes
13761.0,49,2,974.65,2,1,3,6,Clientes Emergentes
13762.0,218,1,133.2,1,1,1,3,Clientes Churn
13763.0,62,1,308.40000000000003,2,1,2,5,Clientes Emergentes
13764.0,70,3,1352.96,2,2,3,7,Clientes Emergentes
13767.0,1,36,7636.66,3,3,3,9,Clientes VIP
13769.0,1,10,2138.4700000000003,3,3,3,9,Clientes VIP
13771.0,63,4,2188.72,2,2,3,7,Clientes Emergentes
13772.0,33,3,1027.43,2,2,3,7,Clientes Emergentes
13774.0,81,1,314.15000000000003,2,1,2,5,Clientes Emergentes
13777.0,8,20,3343.69,3,3,3,9,Clientes VIP
13778.0,102,1,178.7,1,1,1,3,Clientes Churn
13780.0,6,2,247.31,3,1,1,5,Clientes Emergentes
13781.0,250,1,68.54,1,1,1,3,Clientes Churn
13782.0,12,6,766.56,3,3,2,8,Clientes VIP
13784.0,112,5,247.26,1,2,1,4,Clientes Churn
13786.0,366,1,148.8,1,1,1,3,Clientes Churn
13787.0,75,2,231.55,2,1,1,4,Clientes Churn
13790.0,3,1,236.84,3,1,1,5,Clientes Emergentes
13792.0,65,2,183.05,2,1,1,4,Clientes Churn
13798.0,7,24,2138.11,3,3,3,9,Clientes VIP
13799.0,116,2,649.06,1,1,2,4,Clientes Churn
13800.0,309,1,486.62,1,1,2,4,Clientes Churn
13801.0,66,1,247.1,2,1,1,4,Clientes Churn
13802.0,138,3,1068.52,1,2,3,6,Clientes Emergentes
13803.0,254,1,277.07,1,1,1,3,Clientes Churn
13804.0,30,7,2303.89,2,3,3,8,Clientes VIP
13806.0,63,1,218.13000000000002,2,1,1,4,Clientes Churn
13807.0,366,1,80.8,1,1,1,3,Clientes Churn
13808.0,5,5,1115.66,3,2,3,8,Clientes VIP
13809.0,304,1,60.300000000000004,1,1,1,3,Clientes Churn
13810.0,28,2,609.16,2,1,2,5,Clientes Emergentes
13812.0,41,3,452.1,2,2,2,6,Clientes Emergentes
13813.0,39,4,1050.26,2,2,3,7,Clientes Emergentes
13814.0,91,2,1334.22,1,1,3,5,Clientes Emergentes
13815.0,21,4,3007.46,3,2,3,8,Clientes VIP
13816.0,23,2,420.42,3,1,2,6,Clientes Emergentes
13817.0,28,2,328.98,2,1,2,5,Clientes Emergentes
13819.0,301,3,624.75,1,2,2,5,Clientes Emergentes
13821.0,144,2,321.89,1,1,2,4,Clientes Churn
13822.0,5,2,454.8,3,1,2,6,Clientes Emergentes
13823.0,18,2,683.36,3,1,2,6,Clientes Emergentes
13824.0,32,5,1171.86,2,2,3,7,Clientes Emergentes
13826.0,175,1,102.30000000000001,1,1,1,3,Clientes Churn
13827.0,57,3,239.9,2,2,1,5,Clientes Emergentes
13828.0,21,1,168.45,3,1,1,5,Clientes Emergentes
13831.0,15,4,527.17,3,2,2,7,Clientes Emergentes
13832.0,18,1,52.199999999999996,3,1,1,5,Clientes Emergentes
13833.0,158,1,226.4,1,1,1,3,Clientes Churn
13835.0,24,4,692.37,3,2,2,7,Clientes Emergentes
13837.0,211,2,226.24,1,1,1,3,Clientes Churn
13838.0,5,4,527.58,3,2,2,7,Clientes Emergentes
13842.0,58,9,2555.65,2,3,3,8,Clientes VIP
13844.0,10,1,345.12,3,1,2,6,Clientes Emergentes
13845.0,64,1,157.86,2,1,1,4,Clientes Churn
13846.0,24,3,733.16,3,2,2,7,Clientes Emergentes
13849.0,51,2,1325.55,2,1,3,6,Clientes Emergentes
13850.0,128,1,1478.98,1,1,3,5,Clientes Emergentes
13851.0,95,3,1536.08,1,2,3,6,Clientes Emergentes
13853.0,56,1,547.3000000000001,2,1,2,5,Clientes Emergentes
13854.0,8,24,2557.92,3,3,3,9,Clientes VIP
13856.0,168,3,120.3,1,2,1,4,Clientes Churn
13858.0,56,1,182.67,2,1,1,4,Clientes Churn
13859.0,325,1,172.76000000000002,1,1,1,3,Clientes Churn
13860.0,0,5,1106.93,3,2,3,8,Clientes VIP
13862.0,17,8,2131.96,3,3,3,9,Clientes VIP
13863.0,247,1,264.88,1,1,1,3,Clientes Churn
13865.0,57,4,437.81,2,2,2,6,Clientes Emergentes
13866.0,73,1,145.67000000000002,2,1,1,4,Clientes Churn
13867.0,30,3,719.74,2,2,2,6,Clientes Emergentes
13868.0,38,1,428.37,2,1,2,5,Clientes Emergentes
13869.0,122,4,2468.25,1,2,3,6,Clientes Emergentes
13870.0,1,8,1713.04,3,3,3,9,Clientes VIP
13871.0,22,13,5070.75,3,3,3,9,Clientes VIP
13873.0,119,3,324.05,1,2,2,5,Clientes Emergentes
13874.0,357,1,247.45000000000002,1,1,1,3,Clientes Churn
13875.0,53,5,1477.82,2,2,3,7,Clientes Emergentes
13876.0,63,1,98.80000000000001,2,1,1,4,Clientes Churn
13877.0,85,1,17.4,2,1,1,4,Clientes Churn
13878.0,54,1,1031.94,2,1,3,6,Clientes Emergentes
13880.0,20,13,2927.18,3,3,3,9,Clientes VIP
13881.0,17,13,2902.56,3,3,3,9,Clientes VIP
13882.0,2,5,686.34,3,2,2,7,Clientes Emergentes
13883.0,10,5,2176.33,3,2,3,8,Clientes VIP
13884.0,6,4,670.45,3,2,2,7,Clientes Emergentes
13885.0,188,2,390.2,1,1,2,4,Clientes Churn
13886.0,70,1,218.56,2,1,1,4,Clientes Churn
13887.0,203,1,293.95,1,1,2,4,Clientes Churn
13888.0,119,2,505.98,1,1,2,4,Clientes Churn
13889.0,92,1,416.90000000000003,1,1,2,4,Clientes Churn
13890.0,0,10,1807.46,3,3,3,9,Clientes VIP
13892.0,26,4,410.01,2,2,2,6,Clientes Emergentes
13893.0,297,1,195.70000000000002,1,1,1,3,Clientes Churn
13894.0,23,2,430.55,3,1,2,6,Clientes Emergentes
13895.0,27,4,2144.67,2,2,3,7,Clientes Emergentes
13897.0,49,1,311.16,2,1,2,5,Clientes Emergentes
13898.0,325,1,138.93,1,1,1,3,Clientes Churn
13899.0,15,2,337.52,3,1,2,6,Clientes Emergentes
13900.0,192,2,553.95,1,1,2,4,Clientes Churn
13901.0,71,5,2365.83,2,2,3,7,Clientes Emergentes
13904.0,36,2,332.64,2,1,2,5,Clientes Emergentes
13908.0,79,4,1948.9,2,2,3,7,Clientes Emergentes
13911.0,143,8,1872.71,1,3,3,7,Clientes Emergentes
13914.0,11,2,604.83,3,1,2,6,Clientes Emergentes
13917.0,49,2,252.14000000000001,2,1,1,4,Clientes Churn
13918.0,49,2,565.1,2,1,2,5,Clientes Emergentes
13919.0,58,2,331.86,2,1,2,5,Clientes Emergentes
13922.0,351,1,81.6,1,1,1,3,Clientes Churn
13923.0,53,1,317.63,2,1,2,5,Clientes Emergentes
13924.0,1,6,1544.05,3,3,3,9,Clientes VIP
13925.0,92,4,411.1,1,2,2,5,Clientes Emergentes
13926.0,22,1,150.10000000000002,3,1,1,5,Clientes Emergentes
13927.0,74,1,348.99,2,1,2,5,Clientes Emergentes
13928.0,10,4,336.47,3,2,2,7,Clientes Emergentes
13929.0,168,2,285.45,1,1,2,4,Clientes Churn
13930.0,57,2,337.34,2,1,2,5,Clientes Emergentes
13931.0,95,2,956.13,1,1,3,5,Clientes Emergentes
13932.0,294,1,195.8,1,1,1,3,Clientes Churn
13933.0,108,2,576.99,1,1,2,4,Clientes Churn
13934.0,263,1,818.65,1,1,2,4,Clientes Churn
13936.0,179,1,369.74,1,1,2,4,Clientes Churn
13937.0,168,1,128.25,1,1,1,3,Clientes Churn
13938.0,34,1,71.66,2,1,1,4,Clientes Churn
13939.0,22,3,466.37,3,2,2,7,Clientes Emergentes
13940.0,16,4,648.5600000000001,3,2,2,7,Clientes Emergentes
13941.0,21,5,1389.88,3,2,3,8,Clientes VIP
13946.0,78,3,57.33,2,2,1,5,Clientes Emergentes
13947.0,64,1,90.6,2,1,1,4,Clientes Churn
13948.0,360,1,70.19999999999999,1,1,1,3,Clientes Churn
13949.0,2,6,2119.84,3,3,3,9,Clientes VIP
13950.0,10,4,437.65999999999997,3,2,2,7,Clientes Emergentes
13951.0,175,3,504.09000000000003,1,2,2,5,Clientes Emergentes
13952.0,217,2,2300.811,1,1,3,5,Clientes Emergentes
13953.0,6,2,265.68,3,1,1,5,Clientes Emergentes
13954.0,1,2,307.82,3,1,2,6,Clientes Emergentes
13955.0,153,2,239.31,1,1,1,3,Clientes Churn
13956.0,4,5,678.54,3,2,2,7,Clientes Emergentes
13959.0,78,3,512.75,2,2,2,6,Clientes Emergentes
13960.0,20,2,230.22,3,1,1,5,Clientes Emergentes
13962.0,21,2,82.1,3,1,1,5,Clientes Emergentes
13963.0,307,4,469.02,1,2,2,5,Clientes Emergentes
13967.0,145,1,35.7,1,1,1,3,Clientes Churn
13969.0,6,18,6503.400000000001,3,3,3,9,Clientes VIP
13971.0,18,8,2502.56,3,3,3,9,Clientes VIP
13972.0,70,2,174.35,2,1,1,4,Clientes Churn
13973.0,286,1,186.75,1,1,1,3,Clientes Churn
13974.0,48,1,413.59000000000003,2,1,2,5,Clientes Emergentes
13975.0,30,6,2280.69,2,3,3,8,Clientes VIP
13976.0,206,1,227.96,1,1,1,3,Clientes Churn
13978.0,14,2,132.53,3,1,1,5,Clientes Emergentes
13979.0,72,1,869.87,2,1,3,6,Clientes Emergentes
13980.0,59,1,116.78,2,1,1,4,Clientes Churn
13982.0,38,4,1424.6,2,2,3,7,Clientes Emergentes
13983.0,39,9,1277.8,2,3,3,8,Clientes VIP
13984.0,26,4,277.43,2,2,1,5,Clientes Emergentes
13985.0,3,15,6863.2300000000005,3,3,3,9,Clientes VIP
13986.0,16,1,186.06,3,1,1,5,Clientes Emergentes
13988.0,19,6,3170.07,3,3,3,9,Clientes VIP
13989.0,65,2,462.21,2,1,2,5,Clientes Emergentes
13990.0,212,1,292.58,1,1,2,4,Clientes Churn
13991.0,11,6,724.93,3,3,2,8,Clientes VIP
13992.0,29,1,76.8,2,1,1,4,Clientes Churn
13993.0,42,8,2127.26,2,3,3,8,Clientes VIP
13994.0,3,6,2028.44,3,3,3,9,Clientes VIP
13995.0,14,5,1308.99,3,2,3,8,Clientes VIP
13999.0,9,12,3506.81,3,3,3,9,Clientes VIP
14000.0,210,1,262.2,1,1,1,3,Clientes Churn
14001.0,45,3,828.0,2,2,3,7,Clientes Emergentes
14002.0,133,2,368.59999999999997,1,1,2,4,Clientes Churn
14004.0,42,7,2921.96,2,3,3,8,Clientes VIP
14005.0,9,5,1242.9,3,2,3,8,Clientes VIP
14006.0,115,3,503.6,1,2,2,5,Clientes Emergentes
14009.0,197,2,646.8100000000001,1,1,2,4,Clientes Churn
14012.0,277,1,328.8,1,1,2,4,Clientes Churn
14013.0,109,3,435.58,1,2,2,5,Clientes Emergentes
14014.0,76,1,304.42,2,1,2,5,Clientes Emergentes
14015.0,52,1,607.62,2,1,2,5,Clientes Emergentes
14016.0,161,4,2642.62,1,2,3,6,Clientes Emergentes
14019.0,46,3,991.01,2,2,3,7,Clientes Emergentes
14020.0,16,2,573.86,3,1,2,6,Clientes Emergentes
14021.0,154,3,495.7,1,2,2,5,Clientes Emergentes
14022.0,224,1,396.8,1,1,2,4,Clientes Churn
14023.0,6,2,540.77,3,1,2,6,Clientes Emergentes
14024.0,121,2,298.45,1,1,2,4,Clientes Churn
14027.0,60,1,104.82,2,1,1,4,Clientes Churn
14029.0,62,2,315.66,2,1,2,5,Clientes Emergentes
14030.0,17,8,1595.95,3,3,3,9,Clientes VIP
14031.0,6,16,6164.41,3,3,3,9,Clientes VIP
14032.0,1,11,2173.0099999999998,3,3,3,9,Clientes VIP
14034.0,21,3,346.77,3,2,2,7,Clientes Emergentes
14035.0,28,5,876.07,2,2,3,7,Clientes Emergentes
14036.0,284,1,451.25,1,1,2,4,Clientes Churn
14037.0,175,2,139.25,1,1,1,3,Clientes Churn
14038.0,77,3,1560.38,2,2,3,7,Clientes Emergentes
14039.0,32,1,82.6,2,1,1,4,Clientes Churn
14040.0,40,12,1932.66,2,3,3,8,Clientes VIP
14041.0,265,1,141.41,1,1,1,3,Clientes Churn
14044.0,26,4,538.52,2,2,2,6,Clientes Emergentes
14046.0,283,1,47.71,1,1,1,3,Clientes Churn
14047.0,8,4,580.2,3,2,2,7,Clientes Emergentes
14048.0,304,1,399.85,1,1,2,4,Clientes Churn
14049.0,16,4,4687.74,3,2,3,8,Clientes VIP
14050.0,31,2,746.36,2,1,2,5,Clientes Emergentes
14051.0,0,23,10378.01,3,3,3,9,Clientes VIP
14052.0,19,1,173.66,3,1,1,5,Clientes Emergentes
14053.0,159,1,41.75,1,1,1,3,Clientes Churn
14054.0,64,1,92.46,2,1,1,4,Clientes Churn
14055.0,105,1,149.14,1,1,1,3,Clientes Churn
14056.0,0,23,5914.15,3,3,3,9,Clientes VIP
14057.0,23,15,4107.2699999999995,3,3,3,9,Clientes VIP
14059.0,266,1,132.6,1,1,1,3,Clientes Churn
14060.0,4,16,2591.62,3,3,3,9,Clientes VIP
14062.0,9,9,2289.89,3,3,3,9,Clientes VIP
14064.0,28,5,803.15,2,2,2,6,Clientes Emergentes
14066.0,266,1,114.3,1,1,1,3,Clientes Churn
14067.0,63,2,275.04,2,1,1,4,Clientes Churn
14068.0,319,1,248.85000000000002,1,1,1,3,Clientes Churn
14071.0,3,8,993.28,3,3,3,9,Clientes VIP
14073.0,31,1,151.04,2,1,1,4,Clientes Churn
14075.0,4,3,728.54,3,2,2,7,Clientes Emergentes
14076.0,128,1,105.52,1,1,1,3,Clientes Churn
14077.0,40,5,354.05,2,2,2,6,Clientes Emergentes
14078.0,101,6,936.7199999999999,1,3,3,7,Clientes Emergentes
14079.0,124,1,147.25,1,1,1,3,Clientes Churn
14080.0,32,1,45.599999999999994,2,1,1,4,Clientes Churn
14081.0,301,2,695.05,1,1,2,4,Clientes Churn
14082.0,364,1,127.05,1,1,1,3,Clientes Churn
14083.0,3,8,835.63,3,3,3,9,Clientes VIP
14085.0,1,18,3866.1,3,3,3,9,Clientes VIP
14087.0,2,1,188.12,3,1,1,5,Clientes Emergentes
14088.0,9,12,15700.62,3,3,3,9,Clientes VIP
14089.0,56,1,113.3,2,1,1,4,Clientes Churn
14092.0,7,14,3874.81,3,3,3,9,Clientes VIP
14093.0,11,1,420.89,3,1,2,6,Clientes Emergentes
14096.0,3,17,36019.84,3,3,3,9,Clientes VIP
14098.0,36,1,147.35,2,1,1,4,Clientes Churn
14099.0,15,11,2668.76,3,3,3,9,Clientes VIP
14100.0,137,1,147.2,1,1,1,3,Clientes Churn
14101.0,294,1,2.95,1,1,1,3,Clientes Churn
14102.0,4,5,817.88,3,2,2,7,Clientes Emergentes
14104.0,165,1,69.71,1,1,1,3,Clientes Churn
14105.0,238,1,1089.14,1,1,3,5,Clientes Emergentes
14107.0,51,7,2413.2200000000003,2,3,3,8,Clientes VIP
14108.0,30,2,544.36,2,1,2,5,Clientes Emergentes
14109.0,72,1,144.2,2,1,1,4,Clientes Churn
14110.0,36,10,2927.37,2,3,3,8,Clientes VIP
14111.0,95,2,63.3,1,1,1,3,Clientes Churn
14112.0,22,6,2505.16,3,3,3,9,Clientes VIP
14113.0,3,4,619.02,3,2,2,7,Clientes Emergentes
14114.0,330,1,195.13,1,1,1,3,Clientes Churn
14116.0,19,5,1091.04,3,2,3,8,Clientes VIP
14117.0,143,1,90.0,1,1,1,3,Clientes Churn
14121.0,3,4,2370.56,3,2,3,8,Clientes VIP
14125.0,10,3,2396.53,3,2,3,8,Clientes VIP
14126.0,10,1,183.4,3,1,1,5,Clientes Emergentes
14127.0,122,3,503.01,1,2,2,5,Clientes Emergentes
14128.0,60,2,625.0,2,1,2,5,Clientes Emergentes
14129.0,1,5,1077.06,3,2,3,8,Clientes VIP
14130.0,318,1,363.41,1,1,2,4,Clientes Churn
14132.0,1,11,2714.17,3,3,3,9,Clientes VIP
14133.0,129,3,499.28999999999996,1,2,2,5,Clientes Emergentes
14135.0,1,15,2849.29,3,3,3,9,Clientes VIP
14138.0,1,2,982.3800000000001,3,1,3,7,Clientes Emergentes
14139.0,45,1,278.28,2,1,1,4,Clientes Churn
14140.0,3,2,913.18,3,1,3,7,Clientes Emergentes
14141.0,2,4,902.38,3,2,3,8,Clientes VIP
14142.0,372,1,280.95,1,1,2,4,Clientes Churn
14143.0,133,1,64.8,1,1,1,3,Clientes Churn
14146.0,8,5,3054.55,3,2,3,8,Clientes VIP
14147.0,77,2,61.8,2,1,1,4,Clientes Churn
14148.0,233,1,29.700000000000003,1,1,1,3,Clientes Churn
14149.0,220,1,421.12,1,1,2,4,Clientes Churn
14150.0,35,2,584.74,2,1,2,5,Clientes Emergentes
14152.0,74,2,602.57,2,1,2,5,Clientes Emergentes
14154.0,238,2,682.92,1,1,2,4,Clientes Churn
14155.0,265,1,118.75,1,1,1,3,Clientes Churn
14156.0,9,41,18300.66,3,3,3,9,Clientes VIP
14157.0,19,2,412.72,3,1,2,6,Clientes Emergentes
14158.0,39,1,397.38,2,1,2,5,Clientes Emergentes
14159.0,19,11,4491.04,3,3,3,9,Clientes VIP
14161.0,215,3,890.92,1,2,3,6,Clientes Emergentes
14162.0,173,2,198.11,1,1,1,3,Clientes Churn
14163.0,86,4,1051.6100000000001,2,2,3,7,Clientes Emergentes
14164.0,80,1,374.4,2,1,2,5,Clientes Emergentes
14165.0,275,1,84.29,1,1,1,3,Clientes Churn
14167.0,38,4,525.09,2,2,2,6,Clientes Emergentes
14171.0,97,1,308.44,1,1,2,4,Clientes Churn
14173.0,10,4,222.34,3,2,1,6,Clientes Emergentes
14174.0,32,1,124.51,2,1,1,4,Clientes Churn
14175.0,59,3,2177.5,2,2,3,7,Clientes Emergentes
14176.0,296,4,517.2,1,2,2,5,Clientes Emergentes
14177.0,85,4,450.77,2,2,2,6,Clientes Emergentes
14178.0,8,7,1467.16,3,3,3,9,Clientes VIP
14179.0,40,2,566.88,2,1,2,5,Clientes Emergentes
14180.0,10,25,1779.8200000000002,3,3,3,9,Clientes VIP
14184.0,66,1,245.59,2,1,1,4,Clientes Churn
14185.0,330,1,12.75,1,1,1,3,Clientes Churn
14188.0,30,6,1763.8600000000001,2,3,3,8,Clientes VIP
14189.0,1,15,3787.7400000000002,3,3,3,9,Clientes VIP
14191.0,1,13,4273.1,3,3,3,9,Clientes VIP
14193.0,67,2,737.15,2,1,2,5,Clientes Emergentes
14194.0,4,21,9440.61,3,3,3,9,Clientes VIP
14196.0,106,1,73.72,1,1,1,3,Clientes Churn
14198.0,17,4,504.6,3,2,2,7,Clientes Emergentes
14199.0,217,1,10.2,1,1,1,3,Clientes Churn
14201.0,59,7,522.64,2,3,2,7,Clientes Emergentes
14204.0,1,1,138.58,3,1,1,5,Clientes Emergentes
14205.0,16,2,288.2,3,1,2,6,Clientes Emergentes
14206.0,238,1,302.65999999999997,1,1,2,4,Clientes Churn
14208.0,94,1,101.14,1,1,1,3,Clientes Churn
14209.0,10,6,1098.55,3,3,3,9,Clientes VIP
14210.0,105,6,1616.1200000000001,1,3,3,7,Clientes Emergentes
14211.0,52,9,1761.15,2,3,3,8,Clientes VIP
14214.0,30,5,938.14,2,2,3,7,Clientes Emergentes
14215.0,11,6,1650.47,3,3,3,9,Clientes VIP
14216.0,2,4,1082.66,3,2,3,8,Clientes VIP
14217.0,1,17,1253.13,3,3,3,9,Clientes VIP
14218.0,42,1,169.48000000000002,2,1,1,4,Clientes Churn
14219.0,3,1,73.44,3,1,1,5,Clientes Emergentes
14220.0,246,2,510.72,1,1,2,4,Clientes Churn
14221.0,41,9,2655.95,2,3,3,8,Clientes VIP
14222.0,176,1,576.5,1,1,2,4,Clientes Churn
14223.0,91,3,736.5600000000001,1,2,2,5,Clientes Emergentes
14224.0,109,4,685.6,1,2,2,5,Clientes Emergentes
14226.0,29,4,1273.89,2,2,3,7,Clientes Emergentes
14227.0,25,9,2897.32,2,3,3,8,Clientes VIP
14229.0,51,3,757.8,2,2,2,6,Clientes Emergentes
14231.0,183,3,793.26,1,2,2,5,Clientes Emergentes
14232.0,42,5,1630.66,2,2,3,7,Clientes Emergentes
14233.0,48,4,916.9200000000001,2,2,3,7,Clientes Emergentes
14234.0,21,4,728.26,3,2,2,7,Clientes Emergentes
14235.0,74,5,1505.34,2,2,3,7,Clientes Emergentes
14236.0,80,2,302.64,2,1,2,5,Clientes Emergentes
14237.0,372,1,77.45,1,1,1,3,Clientes Churn
14238.0,325,1,96.2,1,1,1,3,Clientes Churn
14239.0,42,11,1996.75,2,3,3,8,Clientes VIP
14240.0,29,2,745.14,2,1,2,5,Clientes Emergentes
14241.0,183,1,213.70000000000002,1,1,1,3,Clientes Churn
14242.0,234,2,219.25,1,1,1,3,Clientes Churn
14243.0,8,10,2205.13,3,3,3,9,Clientes VIP
14245.0,219,2,1516.7,1,1,3,5,Clientes Emergentes
14246.0,110,3,1293.0,1,2,3,6,Clientes Emergentes
14247.0,277,1,104.12,1,1,1,3,Clientes Churn
14248.0,317,1,98.58,1,1,1,3,Clientes Churn
14250.0,6,3,1823.13,3,2,3,8,Clientes VIP
14251.0,1,5,1796.8200000000002,3,2,3,8,Clientes VIP
14256.0,259,2,738.0600000000001,1,1,2,4,Clientes Churn
14257.0,63,5,2451.6,2,2,3,7,Clientes Emergentes
14258.0,8,9,2439.26,3,3,3,9,Clientes VIP
14259.0,141,1,104.1,1,1,1,3,Clientes Churn
14261.0,78,1,633.79,2,1,2,5,Clientes Emergentes
14262.0,7,8,2337.11,3,3,3,9,Clientes VIP
14264.0,154,2,177.17000000000002,1,1,1,3,Clientes Churn
14267.0,162,3,940.44,1,2,3,6,Clientes Emergentes
14270.0,331,1,341.65000000000003,1,1,2,4,Clientes Churn
14271.0,225,1,92.42,1,1,1,3,Clientes Churn
14272.0,73,2,330.2,2,1,2,5,Clientes Emergentes
14273.0,50,4,559.97,2,2,2,6,Clientes Emergentes
14276.0,98,3,1042.49,1,2,3,6,Clientes Emergentes
14277.0,14,3,2858.52,3,2,3,8,Clientes VIP
14280.0,196,1,92.63999999999999,1,1,1,3,Clientes Churn
14282.0,2,15,2679.78,3,3,3,9,Clientes VIP
14284.0,30,2,505.3,2,1,2,5,Clientes Emergentes
14285.0,20,4,368.78000000000003,3,2,2,7,Clientes Emergentes
14286.0,23,3,3926.34,3,2,3,8,Clientes VIP
14287.0,7,2,159.35,3,1,1,5,Clientes Emergentes
14288.0,212,1,306.0,1,1,2,4,Clientes Churn
14289.0,8,6,508.06,3,3,2,8,Clientes VIP
14290.0,10,5,1983.2,3,2,3,8,Clientes VIP
14291.0,1,11,3262.5,3,3,3,9,Clientes VIP
14292.0,7,9,1665.33,3,3,3,9,Clientes VIP
14293.0,2,4,951.1600000000001,3,2,3,8,Clientes VIP
14295.0,39,1,166.20000000000002,2,1,1,4,Clientes Churn
14297.0,17,4,1102.85,3,2,3,8,Clientes VIP
14298.0,7,40,24387.53,3,3,3,9,Clientes VIP
14299.0,7,8,2234.89,3,3,3,9,Clientes VIP
14300.0,18,1,43.2,3,1,1,5,Clientes Emergentes
14301.0,116,1,128.7,1,1,1,3,Clientes Churn
14304.0,222,1,224.4,1,1,1,3,Clientes Churn
14305.0,70,3,1811.16,2,2,3,7,Clientes Emergentes
14306.0,50,2,697.88,2,1,2,5,Clientes Emergentes
14307.0,88,6,2682.61,2,3,3,8,Clientes VIP
14309.0,7,9,1766.45,3,3,3,9,Clientes VIP
14311.0,242,1,198.97,1,1,1,3,Clientes Churn
14312.0,46,6,1265.06,2,3,3,8,Clientes VIP
14314.0,106,1,93.47999999999999,1,1,1,3,Clientes Churn
14315.0,44,6,2014.03,2,3,3,8,Clientes VIP
14317.0,64,1,375.58,2,1,2,5,Clientes Emergentes
14320.0,206,2,457.89,1,1,2,4,Clientes Churn
14321.0,10,5,1178.4,3,2,3,8,Clientes VIP
14323.0,114,2,517.66,1,1,2,4,Clientes Churn
14326.0,241,1,123.85000000000001,1,1,1,3,Clientes Churn
14327.0,162,1,311.65,1,1,2,4,Clientes Churn
14329.0,16,7,4013.63,3,3,3,9,Clientes VIP
14331.0,123,2,395.76,1,1,2,4,Clientes Churn
14332.0,22,3,585.15,3,2,2,7,Clientes Emergentes
14333.0,67,1,188.20000000000002,2,1,1,4,Clientes Churn
14334.0,16,8,1829.61,3,3,3,9,Clientes VIP
14335.0,15,2,422.6,3,1,2,6,Clientes Emergentes
14336.0,16,4,1281.1100000000001,3,2,3,8,Clientes VIP
14338.0,195,1,443.2,1,1,2,4,Clientes Churn
14339.0,242,1,309.52,1,1,2,4,Clientes Churn
14340.0,218,1,134.7,1,1,1,3,Clientes Churn
14341.0,44,8,1873.77,2,3,3,8,Clientes VIP
14342.0,20,4,322.8,3,2,2,7,Clientes Emergentes
14344.0,126,8,615.5300000000001,1,3,2,6,Clientes Emergentes
14345.0,38,1,108.97999999999999,2,1,1,4,Clientes Churn
14346.0,120,2,799.46,1,1,2,4,Clientes Churn
14348.0,259,1,297.87,1,1,2,4,Clientes Churn
14349.0,9,1,125.0,3,1,1,5,Clientes Emergentes
14350.0,273,1,282.93,1,1,2,4,Clientes Churn
14351.0,164,1,51.0,1,1,1,3,Clientes Churn
14352.0,156,4,821.76,1,2,3,6,Clientes Emergentes
14353.0,214,1,90.6,1,1,1,3,Clientes Churn
14354.0,5,2,126.17999999999999,3,1,1,5,Clientes Emergentes
14355.0,365,1,158.5,1,1,1,3,Clientes Churn
14356.0,79,2,480.93,2,1,2,5,Clientes Emergentes
14357.0,42,1,215.82,2,1,1,4,Clientes Churn
14359.0,18,3,799.08,3,2,2,7,Clientes Emergentes
14360.0,31,4,1732.83,2,2,3,7,Clientes Emergentes
14362.0,21,1,148.45,3,1,1,5,Clientes Emergentes
14364.0,108,8,1022.95,1,3,3,7,Clientes Emergentes
14367.0,7,16,7250.9400000000005,3,3,3,9,Clientes VIP
14368.0,319,1,105.2,1,1,1,3,Clientes Churn
14371.0,294,1,100.5,1,1,1,3,Clientes Churn
14373.0,357,1,10.2,1,1,1,3,Clientes Churn
14375.0,184,1,241.78,1,1,1,3,Clientes Churn
14377.0,190,2,155.25,1,1,1,3,Clientes Churn
14379.0,43,2,340.15000000000003,2,1,2,5,Clientes Emergentes
14381.0,51,1,202.68,2,1,1,4,Clientes Churn
14382.0,25,1,459.15999999999997,2,1,2,5,Clientes Emergentes
14383.0,37,3,903.67,2,2,3,7,Clientes Emergentes
14385.0,8,3,202.11,3,2,1,6,Clientes Emergentes
14386.0,296,1,93.6,1,1,1,3,Clientes Churn
14387.0,32,3,1501.21,2,2,3,7,Clientes Emergentes
14388.0,9,8,2804.56,3,3,3,9,Clientes VIP
14389.0,64,2,792.94,2,1,2,5,Clientes Emergentes
14390.0,9,9,3426.17,3,3,3,9,Clientes VIP
14393.0,217,1,67.95,1,1,1,3,Clientes Churn
14395.0,1,9,3157.01,3,3,3,9,Clientes VIP
14396.0,64,2,451.09,2,1,2,5,Clientes Emergentes
14397.0,2,16,994.8199999999999,3,3,3,9,Clientes VIP
14400.0,148,1,326.48,1,1,2,4,Clientes Churn
14401.0,3,13,2722.94,3,3,3,9,Clientes VIP
14403.0,216,2,283.95000000000005,1,1,2,4,Clientes Churn
14404.0,33,6,1103.73,2,3,3,8,Clientes VIP
14406.0,118,1,106.25,1,1,1,3,Clientes Churn
14407.0,106,5,981.53,1,2,3,6,Clientes Emergentes
14408.0,10,7,1823.53,3,3,3,9,Clientes VIP
14409.0,70,4,875.4200000000001,2,2,3,7,Clientes Emergentes
14410.0,91,9,892.52,1,3,3,7,Clientes Emergentes
14411.0,310,1,539.4000000000001,1,1,2,4,Clientes Churn
14412.0,42,2,562.33,2,1,2,5,Clientes Emergentes
14413.0,361,1,112.75,1,1,1,3,Clientes Churn
14414.0,91,7,1033.42,1,3,3,7,Clientes Emergentes
14415.0,0,13,5181.0,3,3,3,9,Clientes VIP
14416.0,21,2,189.5,3,1,1,5,Clientes Emergentes
14418.0,3,3,1517.64,3,2,3,8,Clientes VIP
14419.0,10,6,1032.21,3,3,3,9,Clientes VIP
14420.0,98,1,387.52,1,1,2,4,Clientes Churn
14421.0,56,2,728.61,2,1,2,5,Clientes Emergentes
14422.0,0,6,3462.69,3,3,3,9,Clientes VIP
14423.0,217,1,20.4,1,1,1,3,Clientes Churn
14426.0,23,9,2998.21,3,3,3,9,Clientes VIP
14427.0,49,2,287.74,2,1,2,5,Clientes Emergentes
14428.0,6,5,784.8100000000001,3,2,2,7,Clientes Emergentes
14431.0,302,1,303.66,1,1,2,4,Clientes Churn
14432.0,9,6,2032.92,3,3,3,9,Clientes VIP
14434.0,21,6,964.8000000000001,3,3,3,9,Clientes VIP
14436.0,98,1,76.56,1,1,1,3,Clientes Churn
14437.0,365,1,63.0,1,1,1,3,Clientes Churn
14438.0,305,1,131.9,1,1,1,3,Clientes Churn
14439.0,319,1,1637.3,1,1,3,5,Clientes Emergentes
14440.0,7,5,1549.88,3,2,3,8,Clientes VIP
14441.0,0,4,1378.5900000000001,3,2,3,8,Clientes VIP
14442.0,204,2,677.47,1,1,2,4,Clientes Churn
14443.0,53,4,1370.33,2,2,3,7,Clientes Emergentes
14446.0,0,4,928.45,3,2,3,8,Clientes VIP
14447.0,18,5,1147.33,3,2,3,8,Clientes VIP
14448.0,8,2,127.80000000000001,3,1,1,5,Clientes Emergentes
14449.0,18,4,873.85,3,2,3,8,Clientes VIP
14450.0,180,3,483.25,1,2,2,5,Clientes Emergentes
14451.0,59,2,645.59,2,1,2,5,Clientes Emergentes
14452.0,10,2,196.89000000000001,3,1,1,5,Clientes Emergentes
14453.0,189,1,109.98,1,1,1,3,Clientes Churn
14456.0,4,9,2695.68,3,3,3,9,Clientes VIP
14457.0,310,1,68.64,1,1,1,3,Clientes Churn
14459.0,154,1,1274.16,1,1,3,5,Clientes Emergentes
14460.0,109,3,150.0,1,2,1,4,Clientes Churn
14461.0,147,3,1468.31,1,2,3,6,Clientes Emergentes
14462.0,65,11,1652.38,2,3,3,8,Clientes VIP
14463.0,204,1,39.599999999999994,1,1,1,3,Clientes Churn
14465.0,246,3,506.77000000000004,1,2,2,5,Clientes Emergentes
14466.0,28,7,1400.65,2,3,3,8,Clientes VIP
14467.0,17,4,532.51,3,2,2,7,Clientes Emergentes
14470.0,11,2,303.99,3,1,2,6,Clientes Emergentes
14472.0,103,8,1556.62,1,3,3,7,Clientes Emergentes
14473.0,73,1,95.28,2,1,1,4,Clientes Churn
14474.0,45,1,240.06,2,1,1,4,Clientes Churn
14475.0,71,3,683.01,2,2,2,6,Clientes Emergentes
14476.0,256,1,205.75,1,1,1,3,Clientes Churn
14477.0,50,1,83.2,2,1,1,4,Clientes Churn
14479.0,253,2,252.65,1,1,1,3,Clientes Churn
14480.0,10,1,262.55,3,1,1,5,Clientes Emergentes
14481.0,164,2,538.41,1,1,2,4,Clientes Churn
14482.0,17,6,1078.67,3,3,3,9,Clientes VIP
14483.0,281,1,137.1,1,1,1,3,Clientes Churn
14484.0,49,1,301.76,2,1,2,5,Clientes Emergentes
14485.0,38,1,147.3,2,1,1,4,Clientes Churn
14487.0,26,6,977.18,2,3,3,8,Clientes VIP
14488.0,67,1,706.18,2,1,2,5,Clientes Emergentes
14489.0,206,1,433.5,1,1,2,4,Clientes Churn
14491.0,174,2,220.98,1,1,1,3,Clientes Churn
14493.0,6,5,2047.03,3,2,3,8,Clientes VIP
14494.0,25,1,139.56,2,1,1,4,Clientes Churn
14495.0,50,2,123.8,2,1,1,4,Clientes Churn
14496.0,311,2,291.92,1,1,2,4,Clientes Churn
14497.0,308,1,335.52,1,1,2,4,Clientes Churn
14498.0,42,5,1519.27,2,2,3,7,Clientes Emergentes
14499.0,25,3,775.62,2,2,2,6,Clientes Emergentes
14500.0,87,2,218.10000000000002,2,1,1,4,Clientes Churn
14501.0,183,2,251.21,1,1,1,3,Clientes Churn
14502.0,19,9,1941.82,3,3,3,9,Clientes VIP
14503.0,2,6,2664.66,3,3,3,9,Clientes VIP
14504.0,46,4,522.21,2,2,2,6,Clientes Emergentes
14505.0,16,8,4977.96,3,3,3,9,Clientes VIP
14506.0,16,5,1258.3700000000001,3,2,3,8,Clientes VIP
14507.0,39,5,944.08,2,2,3,7,Clientes Emergentes
14508.0,21,2,196.42000000000002,3,1,1,5,Clientes Emergentes
14511.0,10,5,1173.41,3,2,3,8,Clientes VIP
14512.0,187,2,175.63,1,1,1,3,Clientes Churn
14513.0,206,2,183.75,1,1,1,3,Clientes Churn
14514.0,60,3,787.5,2,2,2,6,Clientes Emergentes
14515.0,17,6,1567.71,3,3,3,9,Clientes VIP
14517.0,32,2,192.55,2,1,1,4,Clientes Churn
14518.0,63,1,112.44,2,1,1,4,Clientes Churn
14520.0,1,1,10.2,3,1,1,5,Clientes Emergentes
14522.0,71,3,405.26,2,2,2,6,Clientes Emergentes
14523.0,107,1,160.91,1,1,1,3,Clientes Churn
14524.0,31,9,1454.68,2,3,3,8,Clientes VIP
14525.0,19,9,2352.16,3,3,3,9,Clientes VIP
14527.0,2,54,4321.81,3,3,3,9,Clientes VIP
14528.0,36,1,234.83999999999997,2,1,1,4,Clientes Churn
14529.0,59,3,584.39,2,2,2,6,Clientes Emergentes
14530.0,25,6,2017.8500000000001,2,3,3,8,Clientes VIP
14532.0,235,3,200.4,1,2,1,4,Clientes Churn
14533.0,24,6,757.44,3,3,2,8,Clientes VIP
14534.0,2,18,3238.08,3,3,3,9,Clientes VIP
14535.0,59,3,2502.03,2,2,3,7,Clientes Emergentes
14536.0,259,1,76.85000000000001,1,1,1,3,Clientes Churn
14537.0,57,1,355.56,2,1,2,5,Clientes Emergentes
14538.0,64,2,334.35,2,1,2,5,Clientes Emergentes
14539.0,15,2,500.32,3,1,2,6,Clientes Emergentes
14540.0,9,3,880.11,3,2,3,8,Clientes VIP
14541.0,58,8,1380.35,2,3,3,8,Clientes VIP
14542.0,185,1,103.25,1,1,1,3,Clientes Churn
14543.0,28,16,1136.39,2,3,3,8,Clientes VIP
14544.0,23,2,1195.72,3,1,3,7,Clientes Emergentes
14546.0,4,5,2370.54,3,2,3,8,Clientes VIP
14547.0,3,8,3348.55,3,3,3,9,Clientes VIP
14549.0,310,1,224.98000000000002,1,1,1,3,Clientes Churn
14550.0,10,2,659.02,3,1,2,6,Clientes Emergentes
14551.0,17,2,148.23,3,1,1,5,Clientes Emergentes
14552.0,151,1,157.12,1,1,1,3,Clientes Churn
14553.0,18,5,543.62,3,2,2,7,Clientes Emergentes
14554.0,9,4,1946.83,3,2,3,8,Clientes VIP
14555.0,56,2,263.3,2,1,1,4,Clientes Churn
14557.0,84,1,287.44,2,1,2,5,Clientes Emergentes
14560.0,16,13,600.03,3,3,2,8,Clientes VIP
14561.0,75,3,957.37,2,2,3,7,Clientes Emergentes
14562.0,3,18,4055.12,3,3,3,9,Clientes VIP
14565.0,95,4,2636.81,1,2,3,6,Clientes Emergentes
14567.0,56,2,1257.96,2,1,3,6,Clientes Emergentes
14569.0,0,1,80.09,3,1,1,5,Clientes Emergentes
14570.0,280,2,190.21,1,1,1,3,Clientes Churn
14572.0,2,7,2344.81,3,3,3,9,Clientes VIP
14573.0,179,9,792.3000000000001,1,3,2,6,Clientes Emergentes
14576.0,371,1,35.400000000000006,1,1,1,3,Clientes Churn
14577.0,12,4,859.71,3,2,3,8,Clientes VIP
14578.0,2,1,111.51,3,1,1,5,Clientes Emergentes
14581.0,16,1,95.67,3,1,1,5,Clientes Emergentes
14582.0,40,1,94.21000000000001,2,1,1,4,Clientes Churn
14583.0,5,5,857.04,3,2,3,8,Clientes VIP
14584.0,168,4,834.96,1,2,3,6,Clientes Emergentes
14585.0,49,1,148.55,2,1,1,4,Clientes Churn
14586.0,276,1,202.44,1,1,1,3,Clientes Churn
14587.0,18,9,1279.18,3,3,3,9,Clientes VIP
14591.0,14,4,971.14,3,2,3,8,Clientes VIP
14592.0,34,3,528.81,2,2,2,6,Clientes Emergentes
14593.0,21,3,451.79,3,2,2,7,Clientes Emergentes
14594.0,6,2,273.28,3,1,1,5,Clientes Emergentes
14595.0,19,6,1524.96,3,3,3,9,Clientes VIP
14597.0,10,1,312.65,3,1,2,6,Clientes Emergentes
14598.0,43,1,221.97,2,1,1,4,Clientes Churn
14600.0,305,1,236.43,1,1,1,3,Clientes Churn
14601.0,10,1,123.96000000000001,3,1,1,5,Clientes Emergentes
14606.0,0,90,8269.460000000001,3,3,3,9,Clientes VIP
14607.0,18,3,450.9,3,2,2,7,Clientes Emergentes
14608.0,3,3,1017.1500000000001,3,2,3,8,Clientes VIP
14616.0,284,1,10.08,1,1,1,3,Clientes Churn
14618.0,8,3,408.84000000000003,3,2,2,7,Clientes Emergentes
14619.0,245,1,263.74,1,1,1,3,Clientes Churn
14620.0,205,2,318.54,1,1,2,4,Clientes Churn
14621.0,0,5,1490.42,3,2,3,8,Clientes VIP
14622.0,184,1,288.78000000000003,1,1,2,4,Clientes Churn
14623.0,31,5,690.85,2,2,2,6,Clientes Emergentes
14624.0,56,2,225.85,2,1,1,4,Clientes Churn
14625.0,195,2,668.48,1,1,2,4,Clientes Churn
14626.0,23,4,2035.8200000000002,3,2,3,8,Clientes VIP
14628.0,90,2,411.71000000000004,1,1,2,4,Clientes Churn
14629.0,3,2,568.66,3,1,2,6,Clientes Emergentes
14631.0,50,3,722.9200000000001,2,2,2,6,Clientes Emergentes
14632.0,262,1,79.94,1,1,1,3,Clientes Churn
14633.0,265,1,235.4,1,1,1,3,Clientes Churn
14636.0,35,2,609.85,2,1,2,5,Clientes Emergentes
14638.0,50,1,269.6,2,1,1,4,Clientes Churn
14639.0,51,6,2119.57,2,3,3,8,Clientes VIP
14640.0,23,6,1669.46,3,3,3,9,Clientes VIP
14641.0,21,1,110.46,3,1,1,5,Clientes Emergentes
14642.0,58,1,19.8,2,1,1,4,Clientes Churn
14643.0,169,2,295.87,1,1,2,4,Clientes Churn
14644.0,67,2,381.02000000000004,2,1,2,5,Clientes Emergentes
14645.0,156,2,419.42,1,1,2,4,Clientes Churn
14646.0,1,46,11901.92,3,3,3,9,Clientes VIP
14647.0,200,1,243.22,1,1,1,3,Clientes Churn
14649.0,4,4,978.96,3,2,3,8,Clientes VIP
14651.0,66,2,561.15,2,1,2,5,Clientes Emergentes
14652.0,76,1,94.28,2,1,1,4,Clientes Churn
14653.0,0,7,1491.55,3,3,3,9,Clientes VIP
14655.0,7,4,939.2800000000001,3,2,3,8,Clientes VIP
14656.0,168,2,240.95000000000002,1,1,1,3,Clientes Churn
14657.0,17,4,707.37,3,2,2,7,Clientes Emergentes
14658.0,4,2,110.60000000000001,3,1,1,5,Clientes Emergentes
14659.0,8,9,2302.78,3,3,3,9,Clientes VIP
14660.0,86,2,256.24,2,1,1,4,Clientes Churn
14661.0,26,1,41.05,2,1,1,4,Clientes Churn
14662.0,28,4,641.6,2,2,2,6,Clientes Emergentes
14664.0,19,2,568.24,3,1,2,6,Clientes Emergentes
14665.0,60,4,1490.75,2,2,3,7,Clientes Emergentes
14666.0,23,1,175.35,3,1,1,5,Clientes Emergentes
14667.0,10,25,5982.09,3,3,3,9,Clientes VIP
14669.0,241,3,1080.52,1,2,3,6,Clientes Emergentes
14670.0,279,2,403.58,1,1,2,4,Clientes Churn
14672.0,234,2,578.57,1,1,2,4,Clientes Churn
14673.0,2,5,1334.64,3,2,3,8,Clientes VIP
14675.0,15,1,436.4,3,1,2,6,Clientes Emergentes
14676.0,30,5,702.12,2,2,2,6,Clientes Emergentes
14680.0,24,15,3943.2,3,3,3,9,Clientes VIP
14681.0,70,3,120.0,2,2,1,5,Clientes Emergentes
14684.0,25,5,1176.73,2,2,3,7,Clientes Emergentes
14687.0,106,1,217.01999999999998,1,1,1,3,Clientes Churn
14688.0,7,20,3757.69,3,3,3,9,Clientes VIP
14689.0,208,1,104.85,1,1,1,3,Clientes Churn
14690.0,43,2,316.05,2,1,2,5,Clientes Emergentes
14691.0,30,5,1861.94,2,2,3,7,Clientes Emergentes
14692.0,136,4,558.55,1,2,2,5,Clientes Emergentes
14693.0,264,1,45.4,1,1,1,3,Clientes Churn
14696.0,3,7,1750.74,3,3,3,9,Clientes VIP
14697.0,217,2,96.56,1,1,1,3,Clientes Churn
14698.0,1,5,1070.06,3,2,3,8,Clientes VIP
14699.0,213,1,109.13000000000001,1,1,1,3,Clientes Churn
14700.0,31,3,1384.53,2,2,3,7,Clientes Emergentes
14701.0,10,9,1725.8700000000001,3,3,3,9,Clientes VIP
14702.0,0,17,2368.94,3,3,3,9,Clientes VIP
14703.0,14,1,318.17,3,1,2,6,Clientes Emergentes
14704.0,19,7,1343.73,3,3,3,9,Clientes VIP
14708.0,2,2,525.81,3,1,2,6,Clientes Emergentes
14709.0,14,13,4341.82,3,3,3,9,Clientes VIP
14710.0,13,4,548.28,3,2,2,7,Clientes Emergentes
14711.0,9,11,1807.35,3,3,3,9,Clientes VIP
14712.0,28,3,851.73,2,2,3,7,Clientes Emergentes
14713.0,8,11,2151.31,3,3,3,9,Clientes VIP
14714.0,23,1,46.9,3,1,1,5,Clientes Emergentes
14715.0,24,4,687.23,3,2,2,7,Clientes Emergentes
14716.0,42,2,215.5,2,1,1,4,Clientes Churn
14719.0,1,5,1471.18,3,2,3,8,Clientes VIP
14720.0,5,3,443.16,3,2,2,7,Clientes Emergentes
14722.0,146,1,162.07,1,1,1,3,Clientes Churn
14723.0,9,6,1028.28,3,3,3,9,Clientes VIP
14725.0,24,1,450.83,3,1,2,6,Clientes Emergentes
14727.0,273,1,116.03,1,1,1,3,Clientes Churn
14729.0,373,1,290.79,1,1,2,4,Clientes Churn
14730.0,0,8,1576.56,3,3,3,9,Clientes VIP
14731.0,46,3,346.13,2,2,2,6,Clientes Emergentes
14732.0,7,8,2177.19,3,3,3,9,Clientes VIP
14733.0,15,12,4398.04,3,3,3,9,Clientes VIP
14735.0,3,30,4182.42,3,3,3,9,Clientes VIP
14737.0,3,3,530.35,3,2,2,7,Clientes Emergentes
14738.0,42,7,1154.7,2,3,3,8,Clientes VIP
14739.0,19,6,745.38,3,3,2,8,Clientes VIP
14740.0,196,3,1283.86,1,2,3,6,Clientes Emergentes
14741.0,11,6,1270.34,3,3,3,9,Clientes VIP
14744.0,15,6,416.48,3,3,2,8,Clientes VIP
14745.0,112,5,1085.5,1,2,3,6,Clientes Emergentes
14747.0,248,1,176.95000000000002,1,1,1,3,Clientes Churn
14748.0,28,5,1330.09,2,2,3,7,Clientes Emergentes
14752.0,43,1,129.0,2,1,1,4,Clientes Churn
14753.0,86,1,526.75,2,1,2,5,Clientes Emergentes
14754.0,44,2,608.3,2,1,2,5,Clientes Emergentes
14755.0,9,11,4106.17,3,3,3,9,Clientes VIP
14756.0,14,1,577.36,3,1,2,6,Clientes Emergentes
14757.0,74,1,395.5,2,1,2,5,Clientes Emergentes
14758.0,144,4,711.82,1,2,2,5,Clientes Emergentes
14759.0,4,3,1073.07,3,2,3,8,Clientes VIP
14760.0,296,1,89.2,1,1,1,3,Clientes Churn
14761.0,58,2,255.9,2,1,1,4,Clientes Churn
14762.0,263,1,277.12,1,1,1,3,Clientes Churn
14764.0,46,1,79.8,2,1,1,4,Clientes Churn
14765.0,28,3,159.76,2,2,1,5,Clientes Emergentes
14766.0,7,6,2282.42,3,3,3,9,Clientes VIP
14768.0,16,2,192.60000000000002,3,1,1,5,Clientes Emergentes
14769.0,2,8,8443.17,3,3,3,9,Clientes VIP
14770.0,231,2,622.37,1,1,2,4,Clientes Churn
14772.0,111,1,126.50999999999999,1,1,1,3,Clientes Churn
14775.0,57,3,879.42,2,2,3,7,Clientes Emergentes
14776.0,50,11,1239.54,2,3,3,8,Clientes VIP
14778.0,126,2,691.0600000000001,1,1,2,4,Clientes Churn
14779.0,280,3,187.55,1,2,1,4,Clientes Churn
14780.0,54,2,400.88,2,1,2,5,Clientes Emergentes
14782.0,319,1,110.10000000000001,1,1,1,3,Clientes Churn
14784.0,25,2,231.32000000000002,2,1,1,4,Clientes Churn
14785.0,14,1,39.480000000000004,3,1,1,5,Clientes Emergentes
14788.0,6,2,593.82,3,1,2,6,Clientes Emergentes
14789.0,28,1,169.2,2,1,1,4,Clientes Churn
14790.0,16,4,554.46,3,2,2,7,Clientes Emergentes
14792.0,63,1,6.2,2,1,1,4,Clientes Churn
14793.0,20,1,228.99,3,1,1,5,Clientes Emergentes
14794.0,2,6,1060.06,3,3,3,9,Clientes VIP
14795.0,165,1,4.25,1,1,1,3,Clientes Churn
14796.0,0,17,7129.7300000000005,3,3,3,9,Clientes VIP
14798.0,52,3,173.74,2,2,1,5,Clientes Emergentes
14799.0,50,1,32.720000000000006,2,1,1,4,Clientes Churn
14800.0,47,12,3563.22,2,3,3,8,Clientes VIP
14801.0,60,1,184.64,2,1,1,4,Clientes Churn
14803.0,161,3,279.45,1,2,2,5,Clientes Emergentes
14804.0,8,1,224.82,3,1,1,5,Clientes Emergentes
14805.0,14,4,296.45,3,2,2,7,Clientes Emergentes
14806.0,74,1,66.0,2,1,1,4,Clientes Churn
14808.0,39,7,1374.47,2,3,3,8,Clientes VIP
14810.0,40,11,2038.08,2,3,3,8,Clientes VIP
14813.0,369,2,113.48,1,1,1,3,Clientes Churn
14815.0,36,2,737.22,2,1,2,5,Clientes Emergentes
14816.0,196,1,11.9,1,1,1,3,Clientes Churn
14817.0,199,2,962.08,1,1,3,5,Clientes Emergentes
14818.0,73,3,390.05,2,2,2,6,Clientes Emergentes
14819.0,63,2,176.07,2,1,1,4,Clientes Churn
14820.0,20,4,423.79,3,2,2,7,Clientes Emergentes
14821.0,366,1,48.800000000000004,1,1,1,3,Clientes Churn
14823.0,179,3,217.18,1,2,1,4,Clientes Churn
14824.0,9,4,711.71,3,2,2,7,Clientes Emergentes
14825.0,3,12,1985.21,3,3,3,9,Clientes VIP
14828.0,253,1,10.08,1,1,1,3,Clientes Churn
14829.0,28,4,650.83,2,2,2,6,Clientes Emergentes
14830.0,52,1,188.88,2,1,1,4,Clientes Churn
14834.0,17,6,1249.42,3,3,3,9,Clientes VIP
14836.0,9,3,102.44999999999999,3,2,1,6,Clientes Emergentes
14837.0,89,4,1613.5,1,2,3,6,Clientes Emergentes
14840.0,267,1,62.85,1,1,1,3,Clientes Churn
14841.0,52,6,2687.08,2,3,3,8,Clientes VIP
14842.0,43,4,2250.64,2,2,3,7,Clientes Emergentes
14844.0,63,4,1986.51,2,2,3,7,Clientes Emergentes
14847.0,148,1,218.4,1,1,1,3,Clientes Churn
14849.0,21,25,6635.39,3,3,3,9,Clientes VIP
14850.0,311,1,317.25,1,1,2,4,Clientes Churn
14851.0,22,2,416.55,3,1,2,6,Clientes Emergentes
14852.0,57,6,2228.7400000000002,2,3,3,8,Clientes VIP
14853.0,23,2,88.5,3,1,1,5,Clientes Emergentes
14854.0,77,7,1841.38,2,3,3,8,Clientes VIP
14855.0,134,1,91.85,1,1,1,3,Clientes Churn
14856.0,35,3,919.9399999999999,2,2,3,7,Clientes Emergentes
14857.0,59,2,931.17,2,1,3,6,Clientes Emergentes
14859.0,12,4,1190.54,3,2,3,8,Clientes VIP
14860.0,18,1,149.44,3,1,1,5,Clientes Emergentes
14861.0,51,1,83.37,2,1,1,4,Clientes Churn
14862.0,25,2,727.62,2,1,2,5,Clientes Emergentes
14863.0,28,1,266.76,2,1,1,4,Clientes Churn
14865.0,6,2,43.08,3,1,1,5,Clientes Emergentes
14866.0,10,4,316.72,3,2,2,7,Clientes Emergentes
14867.0,185,3,517.78,1,2,2,5,Clientes Emergentes
14868.0,2,8,2629.2400000000002,3,3,3,9,Clientes VIP
14869.0,8,2,603.27,3,1,2,6,Clientes Emergentes
14870.0,261,1,327.25,1,1,2,4,Clientes Churn
14871.0,2,4,522.38,3,2,2,7,Clientes Emergentes
14873.0,209,1,346.93,1,1,2,4,Clientes Churn
14875.0,107,2,788.1500000000001,1,1,2,4,Clientes Churn
14878.0,12,9,1268.84,3,3,3,9,Clientes VIP
14880.0,76,3,540.69,2,2,2,6,Clientes Emergentes
14881.0,19,1,221.2,3,1,1,5,Clientes Emergentes
14882.0,26,2,510.20000000000005,2,1,2,5,Clientes Emergentes
14883.0,18,6,727.75,3,3,2,8,Clientes VIP
14885.0,131,1,102.0,1,1,1,3,Clientes Churn
14886.0,252,1,325.0,1,1,2,4,Clientes Churn
14888.0,206,1,369.2,1,1,2,4,Clientes Churn
14889.0,335,1,135.9,1,1,1,3,Clientes Churn
14890.0,253,1,125.65,1,1,1,3,Clientes Churn
14891.0,147,2,468.1,1,1,2,4,Clientes Churn
14893.0,9,2,1044.63,3,1,3,7,Clientes Emergentes
14894.0,84,1,614.95,2,1,2,5,Clientes Emergentes
14895.0,7,19,8175.24,3,3,3,9,Clientes VIP
14896.0,204,2,457.82,1,1,2,4,Clientes Churn
14897.0,7,4,672.58,3,2,2,7,Clientes Emergentes
14898.0,22,6,915.23,3,3,3,9,Clientes VIP
14901.0,10,8,1040.31,3,3,3,9,Clientes VIP
14902.0,25,1,299.66,2,1,2,5,Clientes Emergentes
14903.0,20,5,2401.73,3,2,3,8,Clientes VIP
14904.0,1,2,577.12,3,1,2,6,Clientes Emergentes
14905.0,157,2,371.35,1,1,2,4,Clientes Churn
14907.0,2,7,2998.58,3,3,3,9,Clientes VIP
14908.0,73,1,135.3,2,1,1,4,Clientes Churn
14910.0,2,4,374.65,3,2,2,7,Clientes Emergentes
14911.0,0,193,85018.78,3,3,3,9,Clientes VIP
14912.0,16,2,323.77,3,1,2,6,Clientes Emergentes
14913.0,35,4,995.12,2,2,3,7,Clientes Emergentes
14915.0,90,2,281.98,1,1,2,4,Clientes Churn
14916.0,70,4,1165.71,2,2,3,7,Clientes Emergentes
14918.0,115,2,1308.89,1,1,3,5,Clientes Emergentes
14920.0,212,2,780.25,1,1,2,4,Clientes Churn
14921.0,29,2,1255.23,2,1,3,6,Clientes Emergentes
14923.0,50,1,629.6,2,1,2,5,Clientes Emergentes
14924.0,245,1,168.05,1,1,1,3,Clientes Churn
14929.0,31,1,172.88,2,1,1,4,Clientes Churn
14930.0,108,3,1513.51,1,2,3,6,Clientes Emergentes
14931.0,4,4,790.88,3,2,2,7,Clientes Emergentes
14932.0,365,1,140.43,1,1,1,3,Clientes Churn
14934.0,81,2,1246.59,2,1,3,6,Clientes Emergentes
14936.0,33,7,5469.07,2,3,3,8,Clientes VIP
14937.0,56,2,1158.68,2,1,3,6,Clientes Emergentes
14944.0,29,12,4288.900000000001,2,3,3,8,Clientes VIP
14946.0,13,1,100.9,3,1,1,5,Clientes Emergentes
14947.0,71,2,275.82,2,1,1,4,Clientes Churn
14948.0,22,6,927.11,3,3,3,9,Clientes VIP
14950.0,18,1,243.5,3,1,1,5,Clientes Emergentes
14951.0,78,1,259.52,2,1,1,4,Clientes Churn
14952.0,59,9,4315.92,2,3,3,8,Clientes VIP
14953.0,24,1,206.74,3,1,1,5,Clientes Emergentes
14954.0,11,1,194.82,3,1,1,5,Clientes Emergentes
14957.0,252,1,58.49,1,1,1,3,Clientes Churn
14958.0,146,3,213.88,1,2,1,4,Clientes Churn
14959.0,63,4,609.54,2,2,2,6,Clientes Emergentes
14960.0,7,2,188.12,3,1,1,5,Clientes Emergentes
14961.0,10,9,6021.2300000000005,3,3,3,9,Clientes VIP
14962.0,270,1,14.850000000000001,1,1,1,3,Clientes Churn
14963.0,9,5,999.09,3,2,3,8,Clientes VIP
14964.0,246,1,81.75,1,1,1,3,Clientes Churn
14965.0,95,1,464.55,1,1,2,4,Clientes Churn
14966.0,14,1,176.2,3,1,1,5,Clientes Emergentes
14967.0,49,1,139.8,2,1,1,4,Clientes Churn
14968.0,29,1,139.09,2,1,1,4,Clientes Churn
14970.0,67,4,1465.51,2,2,3,7,Clientes Emergentes
14971.0,34,3,827.29,2,2,3,7,Clientes Emergentes
14972.0,127,1,53.47,1,1,1,3,Clientes Churn
14973.0,106,3,465.4,1,2,2,5,Clientes Emergentes
14974.0,36,1,94.49000000000001,2,1,1,4,Clientes Churn
14975.0,56,1,38.65,2,1,1,4,Clientes Churn
14976.0,56,6,625.0600000000001,2,3,2,7,Clientes Emergentes
14978.0,71,5,1081.3700000000001,2,2,3,7,Clientes Emergentes
14981.0,245,1,102.12,1,1,1,3,Clientes Churn
14984.0,18,2,92.52,3,1,1,5,Clientes Emergentes
14985.0,197,2,268.08,1,1,1,3,Clientes Churn
14988.0,211,1,305.29,1,1,2,4,Clientes Churn
14995.0,38,2,204.68,2,1,1,4,Clientes Churn
14997.0,45,3,234.32,2,2,1,5,Clientes Emergentes
14998.0,169,2,356.87,1,1,2,4,Clientes Churn
15000.0,47,1,443.42,2,1,2,5,Clientes Emergentes
15002.0,115,4,1525.66,1,2,3,6,Clientes Emergentes
15004.0,146,1,849.15,1,1,3,5,Clientes Emergentes
15005.0,15,28,5630.26,3,3,3,9,Clientes VIP
15006.0,50,1,456.69,2,1,2,5,Clientes Emergentes
15007.0,158,1,146.96,1,1,1,3,Clientes Churn
15009.0,11,3,1161.63,3,2,3,8,Clientes VIP
15010.0,35,1,263.19,2,1,1,4,Clientes Churn
15012.0,53,2,361.19,2,1,2,5,Clientes Emergentes
15014.0,42,2,177.67000000000002,2,1,1,4,Clientes Churn
15016.0,172,1,100.24000000000001,1,1,1,3,Clientes Churn
15017.0,33,1,115.63,2,1,1,4,Clientes Churn
15018.0,38,3,275.36,2,2,1,5,Clientes Emergentes
15019.0,266,1,239.05,1,1,1,3,Clientes Churn
15021.0,8,9,1578.67,3,3,3,9,Clientes VIP
15022.0,11,3,790.32,3,2,2,7,Clientes Emergentes
15023.0,2,11,4561.14,3,3,3,9,Clientes VIP
15024.0,9,9,1495.23,3,3,3,9,Clientes VIP
15025.0,32,1,357.11,2,1,2,5,Clientes Emergentes
15026.0,79,3,343.75,2,2,2,6,Clientes Emergentes
15027.0,30,4,516.35,2,2,2,6,Clientes Emergentes
15028.0,7,4,520.84,3,2,2,7,Clientes Emergentes
15030.0,267,1,20.4,1,1,1,3,Clientes Churn
15031.0,3,4,468.34000000000003,3,2,2,7,Clientes Emergentes
15032.0,255,2,315.25,1,1,2,4,Clientes Churn
15033.0,4,10,2316.64,3,3,3,9,Clientes VIP
15034.0,15,8,3042.46,3,3,3,9,Clientes VIP
15035.0,89,1,227.29000000000002,1,1,1,3,Clientes Churn
15036.0,71,3,377.09999999999997,2,2,2,6,Clientes Emergentes
15038.0,58,6,403.29,2,3,2,7,Clientes Emergentes
15039.0,9,45,14094.52,3,3,3,9,Clientes VIP
15041.0,169,1,151.9,1,1,1,3,Clientes Churn
15042.0,198,1,46.68,1,1,1,3,Clientes Churn
15044.0,18,17,5489.900000000001,3,3,3,9,Clientes VIP
15045.0,151,1,60.06,1,1,1,3,Clientes Churn
15046.0,8,15,2396.03,3,3,3,9,Clientes VIP
15047.0,269,1,329.7,1,1,2,4,Clientes Churn
15048.0,64,4,284.35,2,2,2,6,Clientes Emergentes
15049.0,273,1,40.050000000000004,1,1,1,3,Clientes Churn
15050.0,24,3,1026.69,3,2,3,8,Clientes VIP
15051.0,22,3,1186.13,3,2,3,8,Clientes VIP
15052.0,318,1,135.88,1,1,1,3,Clientes Churn
15053.0,4,3,523.43,3,2,2,7,Clientes Emergentes
15054.0,11,2,277.95,3,1,1,5,Clientes Emergentes
15057.0,274,2,807.0,1,1,2,4,Clientes Churn
15058.0,24,11,1859.34,3,3,3,9,Clientes VIP
15059.0,40,9,1057.8700000000001,2,3,3,8,Clientes VIP
15060.0,7,4,277.59,3,2,1,6,Clientes Emergentes
15061.0,3,33,6687.17,3,3,3,9,Clientes VIP
15062.0,70,4,912.38,2,2,3,7,Clientes Emergentes
15063.0,212,1,70.19999999999999,1,1,1,3,Clientes Churn
15065.0,37,4,2234.06,2,2,3,7,Clientes Emergentes
15066.0,52,1,701.79,2,1,2,5,Clientes Emergentes
15067.0,77,3,1277.2,2,2,3,7,Clientes Emergentes
15068.0,45,2,453.45,2,1,2,5,Clientes Emergentes
15069.0,178,1,825.48,1,1,3,5,Clientes Emergentes
15071.0,93,2,601.82,1,1,2,4,Clientes Churn
15073.0,9,3,1043.41,3,2,3,8,Clientes VIP
15074.0,104,1,748.87,1,1,2,4,Clientes Churn
15075.0,77,1,496.78,2,1,2,5,Clientes Emergentes
15076.0,172,1,771.3,1,1,2,4,Clientes Churn
15078.0,6,31,9220.62,3,3,3,9,Clientes VIP
15079.0,212,3,610.5600000000001,1,2,2,5,Clientes Emergentes
15081.0,21,5,378.7,3,2,2,7,Clientes Emergentes
15083.0,256,1,62.699999999999996,1,1,1,3,Clientes Churn
15087.0,281,1,220.06,1,1,1,3,Clientes Churn
15088.0,20,2,825.52,3,1,3,7,Clientes Emergentes
15089.0,9,6,1906.6100000000001,3,3,3,9,Clientes VIP
15090.0,307,1,263.12,1,1,1,3,Clientes Churn
15091.0,67,1,446.71,2,1,2,5,Clientes Emergentes
15092.0,214,2,279.61,1,1,2,4,Clientes Churn
15093.0,17,6,1807.28,3,3,3,9,Clientes VIP
15095.0,103,4,796.74,1,2,2,5,Clientes Emergentes
15096.0,42,1,206.89000000000001,2,1,1,4,Clientes Churn
15097.0,3,1,215.08,3,1,1,5,Clientes Emergentes
15099.0,83,1,238.70000000000002,2,1,1,4,Clientes Churn
15101.0,8,2,120.13000000000001,3,1,1,5,Clientes Emergentes
15103.0,30,2,573.46,2,1,2,5,Clientes Emergentes
15104.0,196,2,571.49,1,1,2,4,Clientes Churn
15105.0,17,7,1728.99,3,3,3,9,Clientes VIP
15106.0,17,5,1235.45,3,2,3,8,Clientes VIP
15107.0,333,3,104.10000000000001,1,2,1,4,Clientes Churn
15108.0,141,3,983.5500000000001,1,2,3,6,Clientes Emergentes
15109.0,245,1,327.15000000000003,1,1,2,4,Clientes Churn
15110.0,23,4,620.4,3,2,2,7,Clientes Emergentes
15111.0,28,3,1339.68,2,2,3,7,Clientes Emergentes
15113.0,9,3,1690.09,3,2,3,8,Clientes VIP
15114.0,29,10,2650.16,2,3,3,8,Clientes VIP
15115.0,17,1,238.81,3,1,1,5,Clientes Emergentes
15116.0,17,4,1092.68,3,2,3,8,Clientes VIP
15117.0,14,5,1146.73,3,2,3,8,Clientes VIP
15119.0,245,1,162.8,1,1,1,3,Clientes Churn
15120.0,133,1,244.4,1,1,1,3,Clientes Churn
15121.0,49,2,399.07,2,1,2,5,Clientes Emergentes
15122.0,113,3,1286.28,1,2,3,6,Clientes Emergentes
15123.0,6,2,1818.6299999999999,3,1,3,7,Clientes Emergentes
15124.0,22,2,126.5,3,1,1,5,Clientes Emergentes
15125.0,60,9,2362.7,2,3,3,8,Clientes VIP
15127.0,65,1,346.53,2,1,2,5,Clientes Emergentes
15128.0,59,4,1307.74,2,2,3,7,Clientes Emergentes
15129.0,49,10,1583.27,2,3,3,8,Clientes VIP
15130.0,169,1,330.11,1,1,2,4,Clientes Churn
15132.0,17,5,791.69,3,2,2,7,Clientes Emergentes
15133.0,127,3,584.1800000000001,1,2,2,5,Clientes Emergentes
15134.0,14,8,1299.55,3,3,3,9,Clientes VIP
15135.0,238,1,139.05,1,1,1,3,Clientes Churn
15136.0,2,4,1234.5,3,2,3,8,Clientes VIP
15139.0,239,2,169.84,1,1,1,3,Clientes Churn
15140.0,51,7,1604.01,2,3,3,8,Clientes VIP
15142.0,45,1,430.52,2,1,2,5,Clientes Emergentes
15143.0,225,1,239.55,1,1,1,3,Clientes Churn
15144.0,7,17,5997.62,3,3,3,9,Clientes VIP
15145.0,3,4,921.73,3,2,3,8,Clientes VIP
15146.0,164,2,1164.52,1,1,3,5,Clientes Emergentes
15147.0,239,1,382.0,1,1,2,4,Clientes Churn
15148.0,10,1,301.29,3,1,2,6,Clientes Emergentes
15149.0,133,1,327.45000000000005,1,1,2,4,Clientes Churn
15150.0,16,10,4615.33,3,3,3,9,Clientes VIP
15152.0,9,13,3794.9900000000002,3,3,3,9,Clientes VIP
15153.0,30,1,251.82,2,1,1,4,Clientes Churn
15154.0,74,1,199.47,2,1,1,4,Clientes Churn
15156.0,0,3,762.39,3,2,2,7,Clientes Emergentes
15157.0,3,3,1408.73,3,2,3,8,Clientes VIP
15158.0,44,1,119.76,2,1,1,4,Clientes Churn
15159.0,1,28,14334.960000000001,3,3,3,9,Clientes VIP
15160.0,356,1,51.96,1,1,1,3,Clientes Churn
15163.0,17,2,278.77,3,1,1,5,Clientes Emergentes
15164.0,68,3,777.55,2,2,2,6,Clientes Emergentes
15165.0,372,1,362.7,1,1,2,4,Clientes Churn
15167.0,320,1,138.6,1,1,1,3,Clientes Churn
15168.0,25,1,58.86,2,1,1,4,Clientes Churn
15172.0,8,5,1385.88,3,2,3,8,Clientes VIP
15174.0,322,1,120.63,1,1,1,3,Clientes Churn
15175.0,71,1,212.5,2,1,1,4,Clientes Churn
15178.0,259,1,40.5,1,1,1,3,Clientes Churn
15179.0,17,4,1533.79,3,2,3,8,Clientes VIP
15180.0,366,1,87.5,1,1,1,3,Clientes Churn
15181.0,65,3,194.99999999999997,2,2,1,5,Clientes Emergentes
15182.0,153,2,605.85,1,1,2,4,Clientes Churn
15184.0,28,2,288.01,2,1,2,5,Clientes Emergentes
15185.0,69,1,139.92000000000002,2,1,1,4,Clientes Churn
15186.0,13,2,349.85,3,1,2,6,Clientes Emergentes
15187.0,1,12,1994.24,3,3,3,9,Clientes VIP
15189.0,0,39,5114.18,3,3,3,9,Clientes VIP
15192.0,119,3,618.6,1,2,2,5,Clientes Emergentes
15193.0,60,1,336.95,2,1,2,5,Clientes Emergentes
15194.0,2,15,5099.79,3,3,3,9,Clientes VIP
15197.0,10,3,451.11,3,2,2,7,Clientes Emergentes
15198.0,91,2,193.64,1,1,1,3,Clientes Churn
15199.0,58,4,418.70000000000005,2,2,2,6,Clientes Emergentes
15201.0,86,5,1116.54,2,2,3,7,Clientes Emergentes
15203.0,25,6,1757.4,2,3,3,8,Clientes VIP
15204.0,356,1,157.5,1,1,1,3,Clientes Churn
15205.0,84,2,425.25,2,1,2,5,Clientes Emergentes
15206.0,9,4,420.29999999999995,3,2,2,7,Clientes Emergentes
15208.0,0,5,442.57,3,2,2,7,Clientes Emergentes
15210.0,224,1,211.2,1,1,1,3,Clientes Churn
15211.0,59,2,670.9100000000001,2,1,2,5,Clientes Emergentes
15212.0,240,1,62.0,1,1,1,3,Clientes Churn
15213.0,318,2,328.35,1,1,2,4,Clientes Churn
15214.0,1,8,1497.14,3,3,3,9,Clientes VIP
15215.0,46,3,494.24,2,2,2,6,Clientes Emergentes
15216.0,87,1,33.0,2,1,1,4,Clientes Churn
15218.0,10,10,3102.65,3,3,3,9,Clientes VIP
15219.0,175,1,152.8,1,1,1,3,Clientes Churn
15220.0,51,6,1560.45,2,3,3,8,Clientes VIP
15221.0,365,1,162.60000000000002,1,1,1,3,Clientes Churn
15223.0,225,2,444.55,1,1,2,4,Clientes Churn
15224.0,357,2,244.13,1,1,1,3,Clientes Churn
15225.0,233,1,344.70000000000005,1,1,2,4,Clientes Churn
15226.0,310,1,128.91,1,1,1,3,Clientes Churn
15227.0,36,5,891.78,2,2,3,7,Clientes Emergentes
15228.0,65,4,2337.55,2,2,3,7,Clientes Emergentes
15230.0,238,2,429.6,1,1,2,4,Clientes Churn
15232.0,112,2,358.06,1,1,2,4,Clientes Churn
15234.0,276,1,187.88,1,1,1,3,Clientes Churn
15235.0,217,12,2015.51,1,3,3,7,Clientes Emergentes
15236.0,298,1,321.05,1,1,2,4,Clientes Churn
15237.0,1,4,1252.38,3,2,3,8,Clientes VIP
15238.0,28,3,747.23,2,2,2,6,Clientes Emergentes
15239.0,9,2,749.67,3,1,2,6,Clientes Emergentes
15240.0,44,5,1168.8,2,2,3,7,Clientes Emergentes
15241.0,66,8,1347.01,2,3,3,8,Clientes VIP
15243.0,73,1,316.68,2,1,2,5,Clientes Emergentes
15244.0,64,2,565.17,2,1,2,5,Clientes Emergentes
15245.0,133,3,1490.76,1,2,3,6,Clientes Emergentes
15246.0,237,2,458.1,1,1,2,4,Clientes Churn
15247.0,121,1,111.19999999999999,1,1,1,3,Clientes Churn
15249.0,31,13,6298.46,2,3,3,8,Clientes VIP
15251.0,90,7,1307.12,1,3,3,7,Clientes Emergentes
15252.0,35,2,740.78,2,1,2,5,Clientes Emergentes
15253.0,15,5,847.29,3,2,3,8,Clientes VIP
15254.0,126,1,253.32,1,1,1,3,Clientes Churn
15255.0,66,1,865.35,2,1,3,6,Clientes Emergentes
15256.0,148,1,98.45,1,1,1,3,Clientes Churn
15257.0,282,1,40.2,1,1,1,3,Clientes Churn
15258.0,168,2,386.76,1,1,2,4,Clientes Churn
15260.0,99,6,1595.27,1,3,3,7,Clientes Emergentes
15261.0,134,1,254.82,1,1,1,3,Clientes Churn
15262.0,323,1,161.95000000000002,1,1,1,3,Clientes Churn
15263.0,106,1,139.51,1,1,1,3,Clientes Churn
15264.0,63,1,393.74,2,1,2,5,Clientes Emergentes
15265.0,150,2,1076.52,1,1,3,5,Clientes Emergentes
15266.0,337,1,47.7,1,1,1,3,Clientes Churn
15269.0,23,1,118.80000000000001,3,1,1,5,Clientes Emergentes
15270.0,15,6,842.0500000000001,3,3,3,9,Clientes VIP
15271.0,6,15,2196.77,3,3,3,9,Clientes VIP
15272.0,56,2,502.26,2,1,2,5,Clientes Emergentes
15274.0,3,2,681.77,3,1,2,6,Clientes Emergentes
15275.0,37,1,473.29,2,1,2,5,Clientes Emergentes
15276.0,65,1,102.06,2,1,1,4,Clientes Churn
15277.0,46,1,241.98,2,1,1,4,Clientes Churn
15279.0,354,1,240.45,1,1,1,3,Clientes Churn
15280.0,171,1,87.62,1,1,1,3,Clientes Churn
15281.0,58,9,1900.68,2,3,3,8,Clientes VIP
15286.0,49,1,240.55,2,1,1,4,Clientes Churn
15287.0,21,2,414.69,3,1,2,6,Clientes Emergentes
15288.0,42,5,2074.12,2,2,3,7,Clientes Emergentes
15289.0,28,3,689.46,2,2,2,6,Clientes Emergentes
15290.0,4,18,3920.12,3,3,3,9,Clientes VIP
15291.0,25,11,2234.16,2,3,3,8,Clientes VIP
15292.0,200,1,114.24000000000001,1,1,1,3,Clientes Churn
15296.0,50,6,2874.4700000000003,2,3,3,8,Clientes VIP
15297.0,9,3,624.94,3,2,2,7,Clientes Emergentes
15298.0,1,11,3106.88,3,3,3,9,Clientes VIP
15300.0,63,1,454.44,2,1,2,5,Clientes Emergentes
15301.0,50,11,3498.94,2,3,3,8,Clientes VIP
15303.0,289,1,444.42,1,1,2,4,Clientes Churn
15304.0,60,5,242.60000000000002,2,2,1,5,Clientes Emergentes
15306.0,63,3,854.02,2,2,3,7,Clientes Emergentes
15307.0,95,1,119.20000000000002,1,1,1,3,Clientes Churn
15308.0,273,1,218.25,1,1,1,3,Clientes Churn
15311.0,0,91,17756.31,3,3,3,9,Clientes VIP
15312.0,74,4,843.25,2,2,3,7,Clientes Emergentes
15313.0,109,1,52.0,1,1,1,3,Clientes Churn
15314.0,198,1,314.05,1,1,2,4,Clientes Churn
15315.0,63,2,475.21999999999997,2,1,2,5,Clientes Emergentes
15318.0,3,1,284.9,3,1,2,6,Clientes Emergentes
15319.0,283,1,145.0,1,1,1,3,Clientes Churn
15320.0,43,1,189.03,2,1,1,4,Clientes Churn
15321.0,70,3,2062.64,2,2,3,7,Clientes Emergentes
15322.0,85,1,606.66,2,1,2,5,Clientes Emergentes
15325.0,103,1,162.29,1,1,1,3,Clientes Churn
15326.0,333,1,311.71,1,1,2,4,Clientes Churn
15327.0,52,1,125.1,2,1,1,4,Clientes Churn
15329.0,38,3,830.95,2,2,3,7,Clientes Emergentes
15330.0,31,1,29.759999999999998,2,1,1,4,Clientes Churn
15332.0,369,3,1266.86,1,2,3,6,Clientes Emergentes
15333.0,207,1,238.0,1,1,1,3,Clientes Churn
15334.0,156,3,341.72,1,2,2,5,Clientes Emergentes
15335.0,53,1,165.47,2,1,1,4,Clientes Churn
15339.0,65,2,528.71,2,1,2,5,Clientes Emergentes
15341.0,80,1,732.96,2,1,2,5,Clientes Emergentes
15342.0,129,1,391.14,1,1,2,4,Clientes Churn
15343.0,86,1,153.7,2,1,1,4,Clientes Churn
15344.0,31,2,187.79000000000002,2,1,1,4,Clientes Churn
15345.0,45,1,230.39000000000001,2,1,1,4,Clientes Churn
15346.0,332,1,252.42000000000002,1,1,1,3,Clientes Churn
15347.0,365,1,81.60000000000001,1,1,1,3,Clientes Churn
15348.0,71,1,158.04,2,1,1,4,Clientes Churn
15349.0,157,2,367.36,1,1,2,4,Clientes Churn
15350.0,372,1,115.65,1,1,1,3,Clientes Churn
15351.0,11,7,1658.31,3,3,3,9,Clientes VIP
15353.0,254,2,555.1700000000001,1,1,2,4,Clientes Churn
15355.0,28,2,189.3,2,1,1,4,Clientes Churn
15356.0,30,10,2728.95,2,3,3,8,Clientes VIP
15358.0,4,22,7616.46,3,3,3,9,Clientes VIP
15360.0,39,1,427.93,2,1,2,5,Clientes Emergentes
15361.0,361,1,139.8,1,1,1,3,Clientes Churn
15363.0,372,1,310.1,1,1,2,4,Clientes Churn
15364.0,95,2,675.59,1,1,2,4,Clientes Churn
15365.0,25,7,2115.7200000000003,2,3,3,8,Clientes VIP
15366.0,74,2,529.94,2,1,2,5,Clientes Emergentes
15367.0,56,4,1690.8500000000001,2,2,3,7,Clientes Emergentes
15370.0,70,5,1495.2,2,2,3,7,Clientes Emergentes
15373.0,7,10,1400.01,3,3,3,9,Clientes VIP
15374.0,128,1,25.200000000000003,1,1,1,3,Clientes Churn
15376.0,39,3,1092.81,2,2,3,7,Clientes Emergentes
15379.0,168,7,3192.81,1,3,3,7,Clientes Emergentes
15380.0,8,4,268.54,3,2,1,6,Clientes Emergentes
15381.0,267,1,143.1,1,1,1,3,Clientes Churn
15382.0,14,6,5136.82,3,3,3,9,Clientes VIP
15384.0,169,2,591.91,1,1,2,4,Clientes Churn
15385.0,39,1,142.46,2,1,1,4,Clientes Churn
15386.0,185,1,370.74,1,1,2,4,Clientes Churn
15388.0,269,1,140.54,1,1,1,3,Clientes Churn
15392.0,4,4,1374.49,3,2,3,8,Clientes VIP
15393.0,15,2,231.86,3,1,1,5,Clientes Emergentes
15394.0,9,4,1743.69,3,2,3,8,Clientes VIP
15395.0,325,1,74.55000000000001,1,1,1,3,Clientes Churn
15396.0,112,1,204.28,1,1,1,3,Clientes Churn
15397.0,289,1,94.0,1,1,1,3,Clientes Churn
15398.0,15,2,1283.63,3,1,3,7,Clientes Emergentes
15399.0,0,3,768.97,3,2,2,7,Clientes Emergentes
15400.0,127,3,208.6,1,2,1,4,Clientes Churn
15402.0,148,2,396.81,1,1,2,4,Clientes Churn
15405.0,188,1,128.84,1,1,1,3,Clientes Churn
15406.0,30,2,331.79,2,1,2,5,Clientes Emergentes
15407.0,33,4,662.44,2,2,2,6,Clientes Emergentes
15408.0,263,1,121.98,1,1,1,3,Clientes Churn
15410.0,83,8,2612.19,2,3,3,8,Clientes VIP
15411.0,25,4,1022.2,2,2,3,7,Clientes Emergentes
15412.0,170,1,49.79,1,1,1,3,Clientes Churn
15414.0,9,3,675.45,3,2,2,7,Clientes Emergentes
15415.0,312,1,478.29,1,1,2,4,Clientes Churn
15416.0,64,4,2990.0,2,2,3,7,Clientes Emergentes
15417.0,84,1,508.8,2,1,2,5,Clientes Emergentes
15419.0,24,1,84.74,3,1,1,5,Clientes Emergentes
15421.0,58,4,856.94,2,2,3,7,Clientes Emergentes
15422.0,322,2,97.7,1,1,1,3,Clientes Churn
15423.0,37,1,7.5,2,1,1,4,Clientes Churn
15424.0,253,2,304.14,1,1,2,4,Clientes Churn
15426.0,18,5,1239.39,3,2,3,8,Clientes VIP
15427.0,32,3,1306.95,2,2,3,7,Clientes Emergentes
15428.0,14,1,75.06,3,1,1,5,Clientes Emergentes
15429.0,26,2,321.68,2,1,2,5,Clientes Emergentes
15432.0,22,1,171.19,3,1,1,5,Clientes Emergentes
15433.0,213,2,533.3,1,1,2,4,Clientes Churn
15434.0,7,5,833.86,3,2,3,8,Clientes VIP
15435.0,21,1,109.94,3,1,1,5,Clientes Emergentes
15436.0,11,3,965.93,3,2,3,8,Clientes VIP
15437.0,261,1,183.71,1,1,1,3,Clientes Churn
15438.0,130,1,137.13,1,1,1,3,Clientes Churn
15440.0,54,3,307.18,2,2,2,6,Clientes Emergentes
15443.0,1,7,2700.35,3,3,3,9,Clientes VIP
15444.0,8,2,1260.86,3,1,3,7,Clientes Emergentes
15445.0,263,1,68.1,1,1,1,3,Clientes Churn
15447.0,330,1,129.67,1,1,1,3,Clientes Churn
15448.0,312,1,405.04,1,1,2,4,Clientes Churn
15449.0,25,3,903.26,2,2,3,7,Clientes Emergentes
15450.0,29,1,388.94,2,1,2,5,Clientes Emergentes
15452.0,29,3,503.08,2,2,2,6,Clientes Emergentes
15453.0,1,7,1176.72,3,3,3,9,Clientes VIP
15454.0,361,1,157.2,1,1,1,3,Clientes Churn
15456.0,282,3,368.8,1,2,2,5,Clientes Emergentes
15457.0,261,1,217.17,1,1,1,3,Clientes Churn
15458.0,24,1,142.92,3,1,1,5,Clientes Emergentes
15460.0,353,1,169.66,1,1,1,3,Clientes Churn
15462.0,93,3,144.6,1,2,1,4,Clientes Churn
15463.0,28,1,119.3,2,1,1,4,Clientes Churn
15464.0,337,1,717.45,1,1,2,4,Clientes Churn
15465.0,19,18,1854.59,3,3,3,9,Clientes VIP
15466.0,84,1,324.58,2,1,2,5,Clientes Emergentes
15467.0,8,3,499.93,3,2,2,7,Clientes Emergentes
15468.0,50,1,377.91,2,1,2,5,Clientes Emergentes
15469.0,49,2,282.1,2,1,2,5,Clientes Emergentes
15471.0,1,1,371.13,3,1,2,6,Clientes Emergentes
15472.0,112,1,335.15999999999997,1,1,2,4,Clientes Churn
15475.0,76,1,406.31,2,1,2,5,Clientes Emergentes
15478.0,39,2,885.7900000000001,2,1,3,6,Clientes Emergentes
15480.0,115,1,579.25,1,1,2,4,Clientes Churn
15482.0,15,9,2176.88,3,3,3,9,Clientes VIP
15483.0,160,4,201.31,1,2,1,4,Clientes Churn
15484.0,0,4,2517.17,3,2,3,8,Clientes VIP
15485.0,29,3,1398.96,2,2,3,7,Clientes Emergentes
15489.0,22,3,746.39,3,2,2,7,Clientes Emergentes
15491.0,94,6,2358.59,1,3,3,7,Clientes Emergentes
15492.0,27,2,504.73999999999995,2,1,2,5,Clientes Emergentes
15493.0,32,5,1225.2,2,2,3,7,Clientes Emergentes
15494.0,20,2,1058.73,3,1,3,7,Clientes Emergentes
15497.0,17,2,498.0,3,1,2,6,Clientes Emergentes
15498.0,2,26,11199.47,3,3,3,9,Clientes VIP
15500.0,7,4,837.13,3,2,3,8,Clientes VIP
15502.0,15,9,3505.42,3,3,3,9,Clientes VIP
15503.0,362,1,128.64000000000001,1,1,1,3,Clientes Churn
15504.0,80,1,52.83,2,1,1,4,Clientes Churn
15505.0,52,5,1903.86,2,2,3,7,Clientes Emergentes
15506.0,22,3,745.39,3,2,2,7,Clientes Emergentes
15507.0,171,1,296.76,1,1,2,4,Clientes Churn
15508.0,188,6,771.13,1,3,2,6,Clientes Emergentes
15511.0,11,5,539.63,3,2,2,7,Clientes Emergentes
15512.0,155,2,121.0,1,1,1,3,Clientes Churn
15513.0,32,17,8215.22,2,3,3,8,Clientes VIP
15514.0,11,10,2139.74,3,3,3,9,Clientes VIP
15516.0,44,3,53.93,2,2,1,5,Clientes Emergentes
15517.0,232,1,246.72,1,1,1,3,Clientes Churn
15518.0,63,7,1721.78,2,3,3,8,Clientes VIP
15520.0,1,1,320.7,3,1,2,6,Clientes Emergentes
15521.0,39,7,1946.36,2,3,3,8,Clientes VIP
15522.0,32,2,327.5,2,1,2,5,Clientes Emergentes
15523.0,83,1,88.51,2,1,1,4,Clientes Churn
15525.0,1,3,636.12,3,2,2,7,Clientes Emergentes
15526.0,32,1,9.14,2,1,1,4,Clientes Churn
15527.0,18,8,1482.64,3,3,3,9,Clientes VIP
15528.0,253,1,153.43,1,1,1,3,Clientes Churn
15529.0,22,11,3651.56,3,3,3,9,Clientes VIP
15530.0,21,4,1072.96,3,2,3,8,Clientes VIP
15531.0,7,2,1712.65,3,1,3,7,Clientes Emergentes
15532.0,24,4,1107.59,3,2,3,8,Clientes VIP
15533.0,18,3,504.42,3,2,2,7,Clientes Emergentes
15535.0,172,4,285.3,1,2,2,5,Clientes Emergentes
15537.0,162,1,86.02,1,1,1,3,Clientes Churn
15539.0,6,1,478.46,3,1,2,6,Clientes Emergentes
15540.0,10,1,185.22,3,1,1,5,Clientes Emergentes
15541.0,113,1,85.13000000000001,1,1,1,3,Clientes Churn
15543.0,287,1,117.91,1,1,1,3,Clientes Churn
15544.0,8,9,3479.21,3,3,3,9,Clientes VIP
15545.0,53,2,233.12,2,1,1,4,Clientes Churn
15547.0,6,13,3939.47,3,3,3,9,Clientes VIP
15549.0,76,3,1195.81,2,2,3,7,Clientes Emergentes
15550.0,3,4,474.38,3,2,2,7,Clientes Emergentes
15551.0,36,1,270.87,2,1,1,4,Clientes Churn
15552.0,216,1,90.12,1,1,1,3,Clientes Churn
15553.0,59,1,390.93,2,1,2,5,Clientes Emergentes
15554.0,277,1,130.4,1,1,1,3,Clientes Churn
15555.0,11,16,4025.9,3,3,3,9,Clientes VIP
15556.0,23,1,201.37,3,1,1,5,Clientes Emergentes
15557.0,28,1,281.0,2,1,2,5,Clientes Emergentes
15561.0,11,4,520.19,3,2,2,7,Clientes Emergentes
15563.0,21,3,1120.83,3,2,3,8,Clientes VIP
15565.0,49,2,123.66000000000001,2,1,1,4,Clientes Churn
15567.0,18,1,59.7,3,1,1,5,Clientes Emergentes
15568.0,2,3,724.39,3,2,2,7,Clientes Emergentes
15569.0,131,2,59.160000000000004,1,1,1,3,Clientes Churn
15570.0,6,12,3220.88,3,3,3,9,Clientes VIP
15571.0,11,4,558.05,3,2,2,7,Clientes Emergentes
15572.0,4,7,1765.43,3,3,3,9,Clientes VIP
15573.0,31,2,430.56,2,1,2,5,Clientes Emergentes
15574.0,177,4,465.26,1,2,2,5,Clientes Emergentes
15576.0,37,1,595.63,2,1,2,5,Clientes Emergentes
15577.0,150,3,209.53,1,2,1,4,Clientes Churn
15578.0,161,1,119.15,1,1,1,3,Clientes Churn
15579.0,68,2,214.1,2,1,1,4,Clientes Churn
15581.0,155,10,608.13,1,3,2,6,Clientes Emergentes
15582.0,24,3,663.01,3,2,2,7,Clientes Emergentes
15584.0,23,4,571.71,3,2,2,7,Clientes Emergentes
15585.0,176,1,439.4,1,1,2,4,Clientes Churn
15587.0,49,3,305.28,2,2,2,6,Clientes Emergentes
15589.0,255,3,413.73,1,2,2,5,Clientes Emergentes
15592.0,46,1,314.66,2,1,2,5,Clientes Emergentes
15593.0,70,1,199.8,2,1,1,4,Clientes Churn
15594.0,15,5,1648.5,3,2,3,8,Clientes VIP
15596.0,100,5,1109.14,1,2,3,6,Clientes Emergentes
15597.0,34,1,324.57,2,1,2,5,Clientes Emergentes
15598.0,52,1,223.68,2,1,1,4,Clientes Churn
15599.0,26,2,653.6899999999999,2,1,2,5,Clientes Emergentes
15601.0,10,14,5198.57,3,3,3,9,Clientes VIP
15602.0,7,7,619.7,3,3,2,8,Clientes VIP
15604.0,51,1,216.39,2,1,1,4,Clientes Churn
15605.0,35,5,944.5300000000001,2,2,3,7,Clientes Emergentes
15606.0,60,9,2570.92,2,3,3,8,Clientes VIP
15607.0,336,1,87.76,1,1,1,3,Clientes Churn
15608.0,59,3,800.16,2,2,2,6,Clientes Emergentes
15609.0,183,1,268.78000000000003,1,1,1,3,Clientes Churn
15610.0,51,1,112.46000000000001,2,1,1,4,Clientes Churn
15611.0,9,11,682.71,3,3,2,8,Clientes VIP
15612.0,35,2,180.15,2,1,1,4,Clientes Churn
15615.0,9,22,8027.4800000000005,3,3,3,9,Clientes VIP
15618.0,32,4,739.951,2,2,2,6,Clientes Emergentes
15619.0,10,1,99.60000000000001,3,1,1,5,Clientes Emergentes
15620.0,56,3,1207.95,2,2,3,7,Clientes Emergentes
15621.0,3,3,202.01000000000002,3,2,1,6,Clientes Emergentes
15622.0,42,9,3050.79,2,3,3,8,Clientes VIP
15623.0,140,1,229.43,1,1,1,3,Clientes Churn
15624.0,116,4,511.5,1,2,2,5,Clientes Emergentes
15625.0,103,4,1161.42,1,2,3,6,Clientes Emergentes
15626.0,74,2,562.56,2,1,2,5,Clientes Emergentes
15628.0,4,9,2584.34,3,3,3,9,Clientes VIP
15630.0,44,2,977.75,2,1,3,6,Clientes Emergentes
15632.0,15,8,2874.85,3,3,3,9,Clientes VIP
15634.0,16,1,227.65,3,1,1,5,Clientes Emergentes
15636.0,89,2,589.5600000000001,1,1,2,4,Clientes Churn
15637.0,52,1,223.36,2,1,1,4,Clientes Churn
15639.0,133,1,178.02,1,1,1,3,Clientes Churn
15640.0,3,14,8021.030000000001,3,3,3,9,Clientes VIP
15641.0,104,4,1749.32,1,2,3,6,Clientes Emergentes
15643.0,191,3,433.95000000000005,1,2,2,5,Clientes Emergentes
15644.0,165,4,741.55,1,2,2,5,Clientes Emergentes
15645.0,18,1,481.51000000000005,3,1,2,6,Clientes Emergentes
15646.0,157,3,364.57000000000005,1,2,2,5,Clientes Emergentes
15648.0,203,2,483.05,1,1,2,4,Clientes Churn
15651.0,36,3,491.65999999999997,2,2,2,6,Clientes Emergentes
15652.0,90,1,293.09000000000003,1,1,2,4,Clientes Churn
15653.0,115,1,48.0,1,1,1,3,Clientes Churn
15654.0,8,2,380.91,3,1,2,6,Clientes Emergentes
15655.0,242,1,465.57,1,1,2,4,Clientes Churn
15656.0,44,4,569.4,2,2,2,6,Clientes Emergentes
15657.0,22,1,30.0,3,1,1,5,Clientes Emergentes
15658.0,189,4,583.85,1,2,2,5,Clientes Emergentes
15659.0,43,1,77.85,2,1,1,4,Clientes Churn
15660.0,24,8,1470.24,3,3,3,9,Clientes VIP
15661.0,316,1,19.8,1,1,1,3,Clientes Churn
15663.0,105,1,124.1,1,1,1,3,Clientes Churn
15664.0,50,1,311.43,2,1,2,5,Clientes Emergentes
15665.0,167,2,1907.25,1,1,3,5,Clientes Emergentes
15667.0,39,1,301.32,2,1,2,5,Clientes Emergentes
15669.0,39,4,437.0,2,2,2,6,Clientes Emergentes
15670.0,296,1,157.15,1,1,1,3,Clientes Churn
15671.0,25,6,1179.81,2,3,3,8,Clientes VIP
15673.0,87,4,2209.05,2,2,3,7,Clientes Emergentes
15674.0,72,4,1823.6100000000001,2,2,3,7,Clientes Emergentes
15675.0,80,3,216.16,2,2,1,5,Clientes Emergentes
15676.0,18,3,2787.22,3,2,3,8,Clientes VIP
15677.0,48,1,580.93,2,1,2,5,Clientes Emergentes
15678.0,52,1,290.3,2,1,2,5,Clientes Emergentes
15679.0,23,4,690.98,3,2,2,7,Clientes Emergentes
15680.0,8,3,1153.39,3,2,3,8,Clientes VIP
15681.0,24,5,1358.16,3,2,3,8,Clientes VIP
15683.0,116,1,152.95,1,1,1,3,Clientes Churn
15687.0,8,9,2344.23,3,3,3,9,Clientes VIP
15689.0,119,2,238.8,1,1,1,3,Clientes Churn
15690.0,3,2,201.48,3,1,1,5,Clientes Emergentes
15692.0,27,1,191.04,2,1,1,4,Clientes Churn
15694.0,7,11,2436.7599999999998,3,3,3,9,Clientes VIP
15695.0,266,2,357.81,1,1,2,4,Clientes Churn
15696.0,32,8,2253.31,2,3,3,8,Clientes VIP
15699.0,17,1,201.0,3,1,1,5,Clientes Emergentes
15700.0,171,2,551.43,1,1,2,4,Clientes Churn
15701.0,1,4,1188.8,3,2,3,8,Clientes VIP
15703.0,264,1,211.5,1,1,1,3,Clientes Churn
15704.0,139,4,1778.3700000000001,1,2,3,6,Clientes Emergentes
15705.0,200,1,19.5,1,1,1,3,Clientes Churn
15706.0,64,3,714.16,2,2,2,6,Clientes Emergentes
15707.0,34,4,822.36,2,2,3,7,Clientes Emergentes
15708.0,40,7,2712.9700000000003,2,3,3,8,Clientes VIP
15709.0,283,1,69.65,1,1,1,3,Clientes Churn
15712.0,8,5,842.9,3,2,3,8,Clientes VIP
15713.0,142,2,266.6,1,1,1,3,Clientes Churn
15714.0,11,2,255.38000000000002,3,1,1,5,Clientes Emergentes
15716.0,145,4,842.34,1,2,3,6,Clientes Emergentes
15717.0,233,1,150.3,1,1,1,3,Clientes Churn
15719.0,32,13,4647.16,2,3,3,8,Clientes VIP
15720.0,23,1,423.03000000000003,3,1,2,6,Clientes Emergentes
15721.0,11,1,494.58,3,1,2,6,Clientes Emergentes
15722.0,35,4,858.7700000000001,2,2,3,7,Clientes Emergentes
15723.0,364,1,149.4,1,1,1,3,Clientes Churn
15724.0,200,2,218.25,1,1,1,3,Clientes Churn
15725.0,14,1,382.25,3,1,2,6,Clientes Emergentes
15727.0,16,7,3889.91,3,3,3,9,Clientes VIP
15729.0,212,1,85.0,1,1,1,3,Clientes Churn
15730.0,65,3,943.91,2,2,3,7,Clientes Emergentes
15732.0,211,2,280.2,1,1,2,4,Clientes Churn
15733.0,282,1,112.4,1,1,1,3,Clientes Churn
15734.0,114,2,376.35,1,1,2,4,Clientes Churn
15737.0,14,7,948.85,3,3,3,9,Clientes VIP
15738.0,18,16,3804.94,3,3,3,9,Clientes VIP
15739.0,65,1,77.6,2,1,1,4,Clientes Churn
15740.0,48,1,126.80000000000001,2,1,1,4,Clientes Churn
15743.0,15,4,566.3100000000001,3,2,2,7,Clientes Emergentes
15744.0,77,1,6.959999999999999,2,1,1,4,Clientes Churn
15745.0,18,4,928.5400000000001,3,2,3,8,Clientes VIP
15746.0,133,1,182.96,1,1,1,3,Clientes Churn
15747.0,12,3,658.49,3,2,2,7,Clientes Emergentes
15748.0,39,1,139.36,2,1,1,4,Clientes Churn
15750.0,2,8,2173.58,3,3,3,9,Clientes VIP
15752.0,39,7,2605.25,2,3,3,8,Clientes VIP
15754.0,50,3,458.57,2,2,2,6,Clientes Emergentes
15755.0,9,6,2059.84,3,3,3,9,Clientes VIP
15756.0,60,4,459.36,2,2,2,6,Clientes Emergentes
15757.0,65,2,672.88,2,1,2,5,Clientes Emergentes
15758.0,24,1,205.25,3,1,1,5,Clientes Emergentes
15759.0,296,2,77.24000000000001,1,1,1,3,Clientes Churn
15762.0,64,2,482.95000000000005,2,1,2,5,Clientes Emergentes
15763.0,31,2,602.87,2,1,2,5,Clientes Emergentes
15764.0,87,6,2602.27,2,3,3,8,Clientes VIP
15766.0,63,1,273.65999999999997,2,1,1,4,Clientes Churn
15768.0,115,3,331.03,1,2,2,5,Clientes Emergentes
15769.0,234,1,122.03999999999999,1,1,1,3,Clientes Churn
15773.0,5,1,128.8,3,1,1,5,Clientes Emergentes
15774.0,68,1,189.75,2,1,1,4,Clientes Churn
15775.0,244,1,87.9,1,1,1,3,Clientes Churn
15776.0,132,1,164.13,1,1,1,3,Clientes Churn
15777.0,240,3,309.21000000000004,1,2,2,5,Clientes Emergentes
15780.0,183,3,402.08,1,2,2,5,Clientes Emergentes
15781.0,24,3,254.91,3,2,1,6,Clientes Emergentes
15782.0,9,3,1351.38,3,2,3,8,Clientes VIP
15783.0,10,1,165.62,3,1,1,5,Clientes Emergentes
15785.0,32,5,1115.67,2,2,3,7,Clientes Emergentes
15786.0,45,3,4177.65,2,2,3,7,Clientes Emergentes
15787.0,25,3,767.35,2,2,2,6,Clientes Emergentes
15789.0,357,1,297.65999999999997,1,1,2,4,Clientes Churn
15790.0,9,1,145.53,3,1,1,5,Clientes Emergentes
15791.0,43,2,1297.17,2,1,3,6,Clientes Emergentes
15793.0,14,2,133.92000000000002,3,1,1,5,Clientes Emergentes
15795.0,149,1,495.52,1,1,2,4,Clientes Churn
15796.0,0,8,2050.1600000000003,3,3,3,9,Clientes VIP
15799.0,75,3,715.04,2,2,2,6,Clientes Emergentes
15800.0,106,2,590.88,1,1,2,4,Clientes Churn
15801.0,45,3,997.85,2,2,3,7,Clientes Emergentes
15803.0,50,1,154.86,2,1,1,4,Clientes Churn
15804.0,0,13,3350.18,3,3,3,9,Clientes VIP
15805.0,22,16,4706.150000000001,3,3,3,9,Clientes VIP
15806.0,45,3,671.22,2,2,2,6,Clientes Emergentes
15807.0,49,2,798.1,2,1,2,5,Clientes Emergentes
15808.0,305,4,2992.77,1,2,3,6,Clientes Emergentes
15809.0,35,4,321.4,2,2,2,6,Clientes Emergentes
15810.0,78,4,1307.23,2,2,3,7,Clientes Emergentes
15811.0,21,6,1910.63,3,3,3,9,Clientes VIP
15812.0,106,4,506.38000000000005,1,2,2,5,Clientes Emergentes
15813.0,207,2,728.86,1,1,2,4,Clientes Churn
15814.0,16,4,994.09,3,2,3,8,Clientes VIP
15815.0,63,3,522.48,2,2,2,6,Clientes Emergentes
15819.0,48,4,1728.57,2,2,3,7,Clientes Emergentes
15820.0,319,1,116.97999999999999,1,1,1,3,Clientes Churn
15821.0,43,2,396.86,2,1,2,5,Clientes Emergentes
15822.0,2,2,627.02,3,1,2,6,Clientes Emergentes
15825.0,171,1,199.44,1,1,1,3,Clientes Churn
15826.0,55,3,1331.97,2,2,3,7,Clientes Emergentes
15827.0,72,14,1463.24,2,3,3,8,Clientes VIP
15829.0,98,2,517.8199999999999,1,1,2,4,Clientes Churn
15830.0,37,1,459.5,2,1,2,5,Clientes Emergentes
15831.0,57,3,399.14,2,2,2,6,Clientes Emergentes
15832.0,253,1,821.49,1,1,3,5,Clientes Emergentes
15834.0,69,3,1490.08,2,2,3,7,Clientes Emergentes
15835.0,43,4,802.09,2,2,2,6,Clientes Emergentes
15836.0,49,1,49.97,2,1,1,4,Clientes Churn
15837.0,64,1,300.23,2,1,2,5,Clientes Emergentes
15838.0,24,5,717.84,3,2,2,7,Clientes Emergentes
15839.0,32,3,1022.21,2,2,3,7,Clientes Emergentes
15840.0,58,2,317.8,2,1,2,5,Clientes Emergentes
15841.0,72,4,735.0,2,2,2,6,Clientes Emergentes
15843.0,303,1,80.70000000000002,1,1,1,3,Clientes Churn
15844.0,45,1,108.83999999999999,2,1,1,4,Clientes Churn
15845.0,17,8,2953.07,3,3,3,9,Clientes VIP
15847.0,37,2,278.04,2,1,1,4,Clientes Churn
15850.0,18,2,206.94,3,1,1,5,Clientes Emergentes
15852.0,186,2,109.71000000000001,1,1,1,3,Clientes Churn
15853.0,51,1,110.8,2,1,1,4,Clientes Churn
15854.0,3,11,1992.2600000000002,3,3,3,9,Clientes VIP
15855.0,136,5,712.24,1,2,2,5,Clientes Emergentes
15856.0,3,25,9646.51,3,3,3,9,Clientes VIP
15857.0,18,1,174.6,3,1,1,5,Clientes Emergentes
15858.0,15,5,1187.08,3,2,3,8,Clientes VIP
15860.0,40,8,766.8100000000001,2,3,2,7,Clientes Emergentes
15861.0,11,7,2769.61,3,3,3,9,Clientes VIP
15862.0,7,4,657.29,3,2,2,7,Clientes Emergentes
15863.0,25,2,42.44,2,1,1,4,Clientes Churn
15864.0,66,3,334.8,2,2,2,6,Clientes Emergentes
15865.0,40,3,460.18,2,2,2,6,Clientes Emergentes
15866.0,100,1,163.18,1,1,1,3,Clientes Churn
15867.0,4,15,2255.8,3,3,3,9,Clientes VIP
15869.0,276,2,119.4,1,1,1,3,Clientes Churn
15870.0,32,1,337.34000000000003,2,1,2,5,Clientes Emergentes
15872.0,14,2,302.93,3,1,2,6,Clientes Emergentes
15874.0,63,7,1584.3500000000001,2,3,3,8,Clientes VIP
15877.0,1,2,379.13,3,1,2,6,Clientes Emergentes
15880.0,368,1,306.43,1,1,2,4,Clientes Churn
15881.0,311,4,216.19,1,2,1,4,Clientes Churn
15882.0,198,4,425.76000000000005,1,2,2,5,Clientes Emergentes
15883.0,1,2,348.28,3,1,2,6,Clientes Emergentes
15885.0,92,1,258.55,1,1,1,3,Clientes Churn
15886.0,59,1,104.5,2,1,1,4,Clientes Churn
15888.0,80,1,91.81,2,1,1,4,Clientes Churn
15889.0,156,2,360.47,1,1,2,4,Clientes Churn
15891.0,226,1,407.16,1,1,2,4,Clientes Churn
15894.0,252,2,255.60000000000002,1,1,1,3,Clientes Churn
15895.0,149,1,21.85,1,1,1,3,Clientes Churn
15897.0,193,2,96.43,1,1,1,3,Clientes Churn
15898.0,0,5,688.58,3,2,2,7,Clientes Emergentes
15899.0,368,1,43.5,1,1,1,3,Clientes Churn
15900.0,23,1,351.11,3,1,2,6,Clientes Emergentes
15901.0,16,3,284.91,3,2,2,7,Clientes Emergentes
15903.0,9,7,2050.44,3,3,3,9,Clientes VIP
15904.0,7,1,128.23,3,1,1,5,Clientes Emergentes
15906.0,19,7,1247.79,3,3,3,9,Clientes VIP
15907.0,3,3,834.1,3,2,3,8,Clientes VIP
15909.0,173,1,191.94,1,1,1,3,Clientes Churn
15910.0,0,8,1157.53,3,3,3,9,Clientes VIP
15912.0,177,2,254.67000000000002,1,1,1,3,Clientes Churn
15916.0,15,7,1091.72,3,3,3,9,Clientes VIP
15917.0,247,1,60.550000000000004,1,1,1,3,Clientes Churn
15918.0,190,2,334.23,1,1,2,4,Clientes Churn
15919.0,19,2,589.44,3,1,2,6,Clientes Emergentes
15920.0,153,4,158.55,1,2,1,4,Clientes Churn
15921.0,172,1,164.06,1,1,1,3,Clientes Churn
15922.0,372,1,208.10000000000002,1,1,1,3,Clientes Churn
15923.0,372,1,78.3,1,1,1,3,Clientes Churn
15925.0,193,1,168.9,1,1,1,3,Clientes Churn
15930.0,66,1,393.63,2,1,2,5,Clientes Emergentes
15932.0,3,8,1591.41,3,3,3,9,Clientes VIP
15933.0,20,3,1035.05,3,2,3,8,Clientes VIP
15935.0,238,1,91.04,1,1,1,3,Clientes Churn
15937.0,63,1,145.35,2,1,1,4,Clientes Churn
15938.0,111,5,297.58,1,2,2,5,Clientes Emergentes
15939.0,89,11,834.16,1,3,3,7,Clientes Emergentes
15942.0,133,1,255.54,1,1,1,3,Clientes Churn
15944.0,276,1,149.9,1,1,1,3,Clientes Churn
15945.0,364,1,13.6,1,1,1,3,Clientes Churn
15947.0,82,1,349.64,2,1,2,5,Clientes Emergentes
15948.0,7,2,931.84,3,1,3,7,Clientes Emergentes
15949.0,16,2,349.6,3,1,2,6,Clientes Emergentes
15950.0,31,4,1607.71,2,2,3,7,Clientes Emergentes
15951.0,8,2,583.27,3,1,2,6,Clientes Emergentes
15952.0,33,4,694.7,2,2,2,6,Clientes Emergentes
15953.0,14,8,958.03,3,3,3,9,Clientes VIP
15955.0,23,14,3714.51,3,3,3,9,Clientes VIP
15957.0,31,1,399.04,2,1,2,5,Clientes Emergentes
15958.0,73,1,87.85,2,1,1,4,Clientes Churn
15963.0,19,2,434.36,3,1,2,6,Clientes Emergentes
15965.0,16,4,788.77,3,2,2,7,Clientes Emergentes
15967.0,22,2,373.43,3,1,2,6,Clientes Emergentes
15969.0,2,3,272.7,3,2,1,6,Clientes Emergentes
15970.0,303,1,314.1,1,1,2,4,Clientes Churn
15971.0,52,7,273.05,2,3,1,6,Clientes Emergentes
15973.0,366,1,34.4,1,1,1,3,Clientes Churn
15974.0,38,7,2880.81,2,3,3,8,Clientes VIP
15975.0,83,1,371.01,2,1,2,5,Clientes Emergentes
15976.0,164,2,379.08,1,1,2,4,Clientes Churn
15977.0,16,2,633.32,3,1,2,6,Clientes Emergentes
15978.0,76,1,942.58,2,1,3,6,Clientes Emergentes
15980.0,88,3,1250.0,2,2,3,7,Clientes Emergentes
15981.0,24,8,2328.48,3,3,3,9,Clientes VIP
15983.0,21,4,1129.81,3,2,3,8,Clientes VIP
15984.0,2,9,1872.7,3,3,3,9,Clientes VIP
15985.0,122,2,569.1800000000001,1,1,2,4,Clientes Churn
15986.0,29,1,126.11999999999999,2,1,1,4,Clientes Churn
15987.0,11,5,524.95,3,2,2,7,Clientes Emergentes
15988.0,18,1,113.38,3,1,1,5,Clientes Emergentes
15990.0,43,2,604.01,2,1,2,5,Clientes Emergentes
15992.0,3,1,27.04,3,1,1,5,Clientes Emergentes
15993.0,8,6,2268.58,3,3,3,9,Clientes VIP
15994.0,54,1,355.17,2,1,2,5,Clientes Emergentes
15996.0,87,6,796.48,2,3,2,7,Clientes Emergentes
15998.0,36,5,2473.86,2,2,3,7,Clientes Emergentes
16003.0,29,5,1628.8700000000001,2,2,3,7,Clientes Emergentes
16005.0,11,4,506.74,3,2,2,7,Clientes Emergentes
16006.0,210,1,101.4,1,1,1,3,Clientes Churn
16007.0,47,4,1600.75,2,2,3,7,Clientes Emergentes
16008.0,23,3,428.26,3,2,2,7,Clientes Emergentes
16009.0,21,4,685.76,3,2,2,7,Clientes Emergentes
16010.0,245,3,407.5,1,2,2,5,Clientes Emergentes
16011.0,7,16,3234.23,3,3,3,9,Clientes VIP
16012.0,34,3,984.87,2,2,3,7,Clientes Emergentes
16013.0,7,7,869.9,3,3,3,9,Clientes VIP
16014.0,37,3,570.13,2,2,2,6,Clientes Emergentes
16015.0,3,3,567.6899999999999,3,2,2,7,Clientes Emergentes
16016.0,2,8,1281.31,3,3,3,9,Clientes VIP
16017.0,46,1,172.03,2,1,1,4,Clientes Churn
16018.0,38,2,332.46,2,1,2,5,Clientes Emergentes
16019.0,46,9,2397.83,2,3,3,8,Clientes VIP
16020.0,16,3,707.01,3,2,2,7,Clientes Emergentes
16022.0,259,1,549.4300000000001,1,1,2,4,Clientes Churn
16023.0,45,3,548.86,2,2,2,6,Clientes Emergentes
16024.0,11,1,224.6,3,1,1,5,Clientes Emergentes
16025.0,29,1,423.15999999999997,2,1,2,5,Clientes Emergentes
16026.0,42,1,236.09,2,1,1,4,Clientes Churn
16027.0,136,3,64.75,1,2,1,4,Clientes Churn
16029.0,65,16,1324.35,2,3,3,8,Clientes VIP
16030.0,309,1,312.85,1,1,2,4,Clientes Churn
16031.0,91,2,435.09000000000003,1,1,2,4,Clientes Churn
16033.0,5,20,6928.900000000001,3,3,3,9,Clientes VIP
16034.0,195,3,407.1,1,2,2,5,Clientes Emergentes
16036.0,86,2,607.69,2,1,2,5,Clientes Emergentes
16037.0,269,3,675.4200000000001,1,2,2,5,Clientes Emergentes
16038.0,7,3,431.98,3,2,2,7,Clientes Emergentes
16040.0,64,3,1018.86,2,2,3,7,Clientes Emergentes
16042.0,21,5,1115.07,3,2,3,8,Clientes VIP
16043.0,37,4,598.74,2,2,2,6,Clientes Emergentes
16045.0,119,4,1133.4,1,2,3,6,Clientes Emergentes
16048.0,372,2,256.44,1,1,1,3,Clientes Churn
16049.0,39,3,1010.97,2,2,3,7,Clientes Emergentes
16050.0,173,1,77.48,1,1,1,3,Clientes Churn
16052.0,53,1,303.54,2,1,2,5,Clientes Emergentes
16053.0,32,2,1075.45,2,1,3,6,Clientes Emergentes
16054.0,144,1,608.5600000000001,1,1,2,4,Clientes Churn
16055.0,220,1,78.0,1,1,1,3,Clientes Churn
16056.0,44,1,490.0,2,1,2,5,Clientes Emergentes
16057.0,15,7,1955.47,3,3,3,9,Clientes VIP
16059.0,65,6,1310.21,2,3,3,8,Clientes VIP
16062.0,9,4,571.52,3,2,2,7,Clientes Emergentes
16063.0,259,1,335.32,1,1,2,4,Clientes Churn
16065.0,364,1,322.79,1,1,2,4,Clientes Churn
16066.0,16,5,1086.57,3,2,3,8,Clientes VIP
16070.0,21,2,852.15,3,1,3,7,Clientes Emergentes
16071.0,44,1,299.29,2,1,2,5,Clientes Emergentes
16072.0,287,1,138.15,1,1,1,3,Clientes Churn
16076.0,2,9,2002.96,3,3,3,9,Clientes VIP
16078.0,283,1,79.2,1,1,1,3,Clientes Churn
16079.0,16,3,98.34,3,2,1,6,Clientes Emergentes
16080.0,81,2,217.16,2,1,1,4,Clientes Churn
16081.0,55,5,2328.85,2,2,3,7,Clientes Emergentes
16083.0,100,2,606.14,1,1,2,4,Clientes Churn
16084.0,298,1,397.58,1,1,2,4,Clientes Churn
16085.0,22,5,852.4,3,2,3,8,Clientes VIP
16086.0,58,5,794.0600000000001,2,2,2,6,Clientes Emergentes
16091.0,154,2,315.06,1,1,2,4,Clientes Churn
16092.0,114,3,752.5600000000001,1,2,2,5,Clientes Emergentes
16093.0,106,1,17.0,1,1,1,3,Clientes Churn
16094.0,11,4,847.93,3,2,3,8,Clientes VIP
16096.0,263,1,124.62,1,1,1,3,Clientes Churn
16097.0,239,1,110.4,1,1,1,3,Clientes Churn
16098.0,87,7,1107.51,2,3,3,8,Clientes VIP
16099.0,49,3,731.9,2,2,2,6,Clientes Emergentes
16101.0,70,1,1261.7,2,1,3,6,Clientes Emergentes
16102.0,41,3,1562.74,2,2,3,7,Clientes Emergentes
16103.0,79,4,644.6,2,2,2,6,Clientes Emergentes
16104.0,61,1,243.56,2,1,1,4,Clientes Churn
16105.0,248,1,165.6,1,1,1,3,Clientes Churn
16106.0,65,1,108.38,2,1,1,4,Clientes Churn
16107.0,28,6,577.9000000000001,2,3,2,7,Clientes Emergentes
16108.0,84,1,811.58,2,1,2,5,Clientes Emergentes
16109.0,218,2,208.32,1,1,1,3,Clientes Churn
16110.0,44,3,1248.68,2,2,3,7,Clientes Emergentes
16112.0,142,2,100.7,1,1,1,3,Clientes Churn
16113.0,182,1,110.15,1,1,1,3,Clientes Churn
16114.0,170,1,135.75000000000003,1,1,1,3,Clientes Churn
16115.0,9,8,1519.47,3,3,3,9,Clientes VIP
16116.0,211,1,446.98,1,1,2,4,Clientes Churn
16117.0,189,1,195.31,1,1,1,3,Clientes Churn
16119.0,7,2,363.96000000000004,3,1,2,6,Clientes Emergentes
16120.0,58,3,588.1,2,2,2,6,Clientes Emergentes
16121.0,56,2,829.96,2,1,3,6,Clientes Emergentes
16122.0,72,4,342.18,2,2,2,6,Clientes Emergentes
16123.0,51,1,254.88,2,1,1,4,Clientes Churn
16124.0,316,1,113.4,1,1,1,3,Clientes Churn
16125.0,366,1,273.45,1,1,1,3,Clientes Churn
16126.0,28,4,4571.2300000000005,2,2,3,7,Clientes Emergentes
16127.0,38,1,656.25,2,1,2,5,Clientes Emergentes
16128.0,17,5,1819.27,3,2,3,8,Clientes VIP
16131.0,51,5,1984.6399999999999,2,2,3,7,Clientes Emergentes
16133.0,3,31,5853.43,3,3,3,9,Clientes VIP
16134.0,21,2,586.29,3,1,2,6,Clientes Emergentes
16135.0,262,1,313.7,1,1,2,4,Clientes Churn
16136.0,59,3,535.94,2,2,2,6,Clientes Emergentes
16139.0,18,3,635.41,3,2,2,7,Clientes Emergentes
16140.0,65,2,501.9,2,1,2,5,Clientes Emergentes
16141.0,87,1,430.70000000000005,2,1,2,5,Clientes Emergentes
16142.0,249,1,356.04,1,1,2,4,Clientes Churn
16143.0,2,6,1948.19,3,3,3,9,Clientes VIP
16145.0,8,11,3235.35,3,3,3,9,Clientes VIP
16146.0,203,2,557.13,1,1,2,4,Clientes Churn
16147.0,133,1,243.08,1,1,1,3,Clientes Churn
16149.0,4,2,251.24,3,1,1,5,Clientes Emergentes
16150.0,42,5,1841.32,2,2,3,7,Clientes Emergentes
16152.0,268,1,712.46,1,1,2,4,Clientes Churn
16153.0,49,5,1463.53,2,2,3,7,Clientes Emergentes
16156.0,8,9,2711.6400000000003,3,3,3,9,Clientes VIP
16157.0,15,3,369.95000000000005,3,2,2,7,Clientes Emergentes
16159.0,281,1,348.2,1,1,2,4,Clientes Churn
16160.0,64,1,173.09999999999997,2,1,1,4,Clientes Churn
16161.0,1,19,4655.76,3,3,3,9,Clientes VIP
16162.0,251,1,11.9,1,1,1,3,Clientes Churn
16163.0,364,1,50.1,1,1,1,3,Clientes Churn
16164.0,16,3,678.54,3,2,2,7,Clientes Emergentes
16168.0,10,23,1838.22,3,3,3,9,Clientes VIP
16169.0,7,4,1651.8200000000002,3,2,3,8,Clientes VIP
16170.0,50,6,1598.52,2,3,3,8,Clientes VIP
16171.0,58,1,73.2,2,1,1,4,Clientes Churn
16172.0,94,5,1091.31,1,2,3,6,Clientes Emergentes
16173.0,15,6,1216.6200000000001,3,3,3,9,Clientes VIP
16174.0,125,2,313.0,1,1,2,4,Clientes Churn
16175.0,93,4,885.09,1,2,3,6,Clientes Emergentes
16177.0,49,1,179.35,2,1,1,4,Clientes Churn
16178.0,137,1,150.1,1,1,1,3,Clientes Churn
16179.0,60,1,177.58,2,1,1,4,Clientes Churn
16180.0,99,8,1928.33,1,3,3,7,Clientes Emergentes
16181.0,72,1,163.94,2,1,1,4,Clientes Churn
16182.0,71,1,72.8,2,1,1,4,Clientes Churn
16183.0,66,1,338.71000000000004,2,1,2,5,Clientes Emergentes
16184.0,63,6,722.58,2,3,2,7,Clientes Emergentes
16185.0,16,2,473.26,3,1,2,6,Clientes Emergentes
16186.0,22,12,3643.08,3,3,3,9,Clientes VIP
16187.0,31,15,5428.56,2,3,3,8,Clientes VIP
16188.0,44,4,910.87,2,2,3,7,Clientes Emergentes
16189.0,15,2,125.57999999999998,3,1,1,5,Clientes Emergentes
16190.0,39,1,94.99000000000001,2,1,1,4,Clientes Churn
16191.0,2,11,2661.2200000000003,3,3,3,9,Clientes VIP
16193.0,236,1,280.63,1,1,2,4,Clientes Churn
16198.0,74,1,286.281,2,1,2,5,Clientes Emergentes
16200.0,3,2,866.1700000000001,3,1,3,7,Clientes Emergentes
16201.0,2,4,1739.92,3,2,3,8,Clientes VIP
16202.0,360,1,247.52,1,1,1,3,Clientes Churn
16203.0,58,4,592.9,2,2,2,6,Clientes Emergentes
16204.0,22,1,405.71,3,1,2,6,Clientes Emergentes
16205.0,30,4,613.68,2,2,2,6,Clientes Emergentes
16206.0,54,4,502.71000000000004,2,2,2,6,Clientes Emergentes
16207.0,24,1,310.38,3,1,2,6,Clientes Emergentes
16208.0,44,2,534.06,2,1,2,5,Clientes Emergentes
16209.0,88,4,744.28,2,2,2,6,Clientes Emergentes
16210.0,1,14,1664.8,3,3,3,9,Clientes VIP
16211.0,88,1,329.22,2,1,2,5,Clientes Emergentes
16212.0,18,2,552.09,3,1,2,6,Clientes Emergentes
16213.0,78,1,82.5,2,1,1,4,Clientes Churn
16214.0,170,3,653.45,1,2,2,5,Clientes Emergentes
16215.0,80,1,186.9,2,1,1,4,Clientes Churn
16216.0,266,1,605.88,1,1,2,4,Clientes Churn
16217.0,234,2,288.45000000000005,1,1,2,4,Clientes Churn
16218.0,29,5,1186.38,2,2,3,7,Clientes Emergentes
16221.0,36,3,672.08,2,2,2,6,Clientes Emergentes
16222.0,317,1,677.9200000000001,1,1,2,4,Clientes Churn
16224.0,56,4,1072.85,2,2,3,7,Clientes Emergentes
16225.0,44,5,1077.8700000000001,2,2,3,7,Clientes Emergentes
16226.0,202,3,181.20000000000002,1,2,1,4,Clientes Churn
16227.0,224,1,314.22,1,1,2,4,Clientes Churn
16229.0,86,2,836.6,2,1,3,6,Clientes Emergentes
16230.0,189,2,516.53,1,1,2,4,Clientes Churn
16232.0,43,4,795.88,2,2,2,6,Clientes Emergentes
16233.0,70,2,373.38,2,1,2,5,Clientes Emergentes
16235.0,40,4,595.71,2,2,2,6,Clientes Emergentes
16236.0,77,1,416.3,2,1,2,5,Clientes Emergentes
16239.0,56,2,363.2,2,1,2,5,Clientes Emergentes
16240.0,23,2,2055.47,3,1,3,7,Clientes Emergentes
16241.0,9,13,2304.71,3,3,3,9,Clientes VIP
16242.0,7,7,3244.43,3,3,3,9,Clientes VIP
16243.0,33,2,227.4,2,1,1,4,Clientes Churn
16244.0,211,2,1475.05,1,1,3,5,Clientes Emergentes
16245.0,23,3,1217.76,3,2,3,8,Clientes VIP
16247.0,169,1,56.28,1,1,1,3,Clientes Churn
16248.0,61,1,152.94,2,1,1,4,Clientes Churn
16249.0,52,5,1103.39,2,2,3,7,Clientes Emergentes
16250.0,260,2,373.54,1,1,2,4,Clientes Churn
16253.0,66,2,2191.18,2,1,3,6,Clientes Emergentes
16255.0,16,8,2180.61,3,3,3,9,Clientes VIP
16256.0,266,1,169.95000000000002,1,1,1,3,Clientes Churn
16258.0,44,5,3245.31,2,2,3,7,Clientes Emergentes
16260.0,50,1,427.45000000000005,2,1,2,5,Clientes Emergentes
16261.0,16,4,615.38,3,2,2,7,Clientes Emergentes
16265.0,8,9,4018.51,3,3,3,9,Clientes VIP
16266.0,73,7,607.99,2,3,2,7,Clientes Emergentes
16268.0,70,2,495.2,2,1,2,5,Clientes Emergentes
16270.0,352,1,685.99,1,1,2,4,Clientes Churn
16271.0,15,4,1246.45,3,2,3,8,Clientes VIP
16272.0,116,1,411.7,1,1,2,4,Clientes Churn
16274.0,372,1,201.65,1,1,1,3,Clientes Churn
16275.0,196,1,322.12,1,1,2,4,Clientes Churn
16276.0,176,1,177.0,1,1,1,3,Clientes Churn
16278.0,99,1,211.03,1,1,1,3,Clientes Churn
16279.0,20,3,1399.8,3,2,3,8,Clientes VIP
16281.0,71,1,121.5,2,1,1,4,Clientes Churn
16282.0,339,1,129.75,1,1,1,3,Clientes Churn
16283.0,5,5,1322.11,3,2,3,8,Clientes VIP
16284.0,30,2,771.13,2,1,2,5,Clientes Emergentes
16287.0,169,1,125.22000000000001,1,1,1,3,Clientes Churn
16292.0,121,1,282.35,1,1,2,4,Clientes Churn
16293.0,21,10,1877.74,3,3,3,9,Clientes VIP
16295.0,9,4,967.26,3,2,3,8,Clientes VIP
16297.0,268,1,277.34000000000003,1,1,1,3,Clientes Churn
16298.0,22,3,385.2,3,2,2,7,Clientes Emergentes
16302.0,126,1,233.22,1,1,1,3,Clientes Churn
16303.0,25,3,3904.43,2,2,3,7,Clientes Emergentes
16305.0,138,1,361.21999999999997,1,1,2,4,Clientes Churn
16306.0,213,6,585.17,1,3,2,6,Clientes Emergentes
16309.0,105,2,666.77,1,1,2,4,Clientes Churn
16311.0,17,2,568.89,3,1,2,6,Clientes Emergentes
16313.0,2,2,203.57,3,1,1,5,Clientes Emergentes
16315.0,330,1,155.52,1,1,1,3,Clientes Churn
16316.0,63,7,1803.72,2,3,3,8,Clientes VIP
16317.0,119,3,1055.63,1,2,3,6,Clientes Emergentes
16318.0,34,1,304.75,2,1,2,5,Clientes Emergentes
16319.0,217,1,404.40000000000003,1,1,2,4,Clientes Churn
16321.0,71,5,346.8,2,2,2,6,Clientes Emergentes
16322.0,0,2,306.85,3,1,2,6,Clientes Emergentes
16324.0,127,3,389.98,1,2,2,5,Clientes Emergentes
16325.0,46,3,560.74,2,2,2,6,Clientes Emergentes
16326.0,5,14,1349.06,3,3,3,9,Clientes VIP
16327.0,13,6,3194.01,3,3,3,9,Clientes VIP
16330.0,17,3,122.66,3,2,1,6,Clientes Emergentes
16332.0,27,7,1242.3,2,3,3,8,Clientes VIP
16337.0,36,1,133.15,2,1,1,4,Clientes Churn
16338.0,156,1,199.85,1,1,1,3,Clientes Churn
16339.0,283,1,30.45,1,1,1,3,Clientes Churn
16340.0,106,1,480.2,1,1,2,4,Clientes Churn
16341.0,24,4,1040.37,3,2,3,8,Clientes VIP
16342.0,74,4,193.96,2,2,1,5,Clientes Emergentes
16343.0,15,2,310.78,3,1,2,6,Clientes Emergentes
16344.0,157,1,101.10000000000001,1,1,1,3,Clientes Churn
16345.0,43,1,421.76,2,1,2,5,Clientes Emergentes
16347.0,10,2,660.7800000000001,3,1,2,6,Clientes Emergentes
16348.0,31,7,1147.95,2,3,3,8,Clientes VIP
16349.0,290,1,12.65,1,1,1,3,Clientes Churn
16350.0,20,4,932.7,3,2,3,8,Clientes VIP
16351.0,332,1,153.9,1,1,1,3,Clientes Churn
16352.0,17,2,494.44,3,1,2,6,Clientes Emergentes
16353.0,17,16,2745.05,3,3,3,9,Clientes VIP
16354.0,62,2,361.40000000000003,2,1,2,5,Clientes Emergentes
16356.0,197,3,211.77,1,2,1,4,Clientes Churn
16357.0,32,3,538.6800000000001,2,2,2,6,Clientes Emergentes
16358.0,0,4,2027.5,3,2,3,8,Clientes VIP
16359.0,6,8,429.36,3,3,2,8,Clientes VIP
16360.0,4,6,2991.26,3,3,3,9,Clientes VIP
16361.0,9,4,716.8100000000001,3,2,2,7,Clientes Emergentes
16362.0,31,5,684.08,2,2,2,6,Clientes Emergentes
16363.0,52,1,75.36,2,1,1,4,Clientes Churn
16364.0,11,2,468.89,3,1,2,6,Clientes Emergentes
16365.0,17,7,547.61,3,3,2,8,Clientes VIP
16366.0,18,1,281.90000000000003,3,1,2,6,Clientes Emergentes
16367.0,36,2,700.58,2,1,2,5,Clientes Emergentes
16368.0,1,2,438.59000000000003,3,1,2,6,Clientes Emergentes
16369.0,17,3,1317.29,3,2,3,8,Clientes VIP
16370.0,81,4,987.91,2,2,3,7,Clientes Emergentes
16372.0,32,2,283.68,2,1,2,5,Clientes Emergentes
16374.0,65,2,402.58,2,1,2,5,Clientes Emergentes
16376.0,8,2,733.64,3,1,2,6,Clientes Emergentes
16378.0,246,3,362.95,1,2,2,5,Clientes Emergentes
16379.0,3,4,2006.68,3,2,3,8,Clientes VIP
16380.0,60,1,142.79,2,1,1,4,Clientes Churn
16383.0,74,2,532.24,2,1,2,5,Clientes Emergentes
16384.0,89,2,502.2,1,1,2,4,Clientes Churn
16385.0,59,3,479.04,2,2,2,6,Clientes Emergentes
16386.0,28,2,287.7,2,1,2,5,Clientes Emergentes
16387.0,322,1,94.36,1,1,1,3,Clientes Churn
16389.0,52,4,807.51,2,2,2,6,Clientes Emergentes
16392.0,269,1,213.54,1,1,1,3,Clientes Churn
16393.0,1,13,3031.09,3,3,3,9,Clientes VIP
16394.0,56,5,786.44,2,2,2,6,Clientes Emergentes
16395.0,60,5,1275.48,2,2,3,7,Clientes Emergentes
16398.0,153,2,972.95,1,1,3,5,Clientes Emergentes
16399.0,18,2,326.55,3,1,2,6,Clientes Emergentes
16400.0,94,1,271.08,1,1,1,3,Clientes Churn
16401.0,0,12,2683.04,3,3,3,9,Clientes VIP
16402.0,264,2,214.75,1,1,1,3,Clientes Churn
16403.0,311,1,177.5,1,1,1,3,Clientes Churn
16404.0,69,1,296.45,2,1,2,5,Clientes Emergentes
16405.0,301,2,74.85,1,1,1,3,Clientes Churn
16406.0,18,1,155.12,3,1,1,5,Clientes Emergentes
16407.0,12,9,1686.23,3,3,3,9,Clientes VIP
16409.0,35,5,1743.04,2,2,3,7,Clientes Emergentes
16411.0,18,2,206.7,3,1,1,5,Clientes Emergentes
16412.0,53,1,151.83,2,1,1,4,Clientes Churn
16413.0,56,1,247.25,2,1,1,4,Clientes Churn
16414.0,21,2,31.6,3,1,1,5,Clientes Emergentes
16415.0,43,1,191.7,2,1,1,4,Clientes Churn
16416.0,26,3,752.3,2,2,2,6,Clientes Emergentes
16418.0,44,3,511.82,2,2,2,6,Clientes Emergentes
16419.0,112,6,535.61,1,3,2,6,Clientes Emergentes
16422.0,16,37,3487.44,3,3,3,9,Clientes VIP
16423.0,24,1,268.78,3,1,1,5,Clientes Emergentes
16424.0,190,1,70.56,1,1,1,3,Clientes Churn
16425.0,301,1,157.4,1,1,1,3,Clientes Churn
16426.0,1,10,1684.89,3,3,3,9,Clientes VIP
16427.0,262,2,166.06,1,1,1,3,Clientes Churn
16429.0,105,1,4.95,1,1,1,3,Clientes Churn
16430.0,56,1,200.05,2,1,1,4,Clientes Churn
16431.0,212,3,567.21,1,2,2,5,Clientes Emergentes
16432.0,63,1,111.0,2,1,1,4,Clientes Churn
16433.0,27,1,120.66,2,1,1,4,Clientes Churn
16434.0,28,7,1202.85,2,3,3,8,Clientes VIP
16438.0,5,5,748.6,3,2,2,7,Clientes Emergentes
16440.0,7,5,3503.27,3,2,3,8,Clientes VIP
16441.0,66,2,358.75,2,1,2,5,Clientes Emergentes
16442.0,1,3,502.69,3,2,2,7,Clientes Emergentes
16444.0,45,4,552.17,2,2,2,6,Clientes Emergentes
16445.0,33,1,208.06,2,1,1,4,Clientes Churn
16446.0,205,1,2.9,1,1,1,3,Clientes Churn
16447.0,135,1,119.66,1,1,1,3,Clientes Churn
16448.0,197,1,163.39000000000001,1,1,1,3,Clientes Churn
16449.0,197,2,606.54,1,1,2,4,Clientes Churn
16450.0,149,1,311.92,1,1,2,4,Clientes Churn
16451.0,87,1,266.97,2,1,1,4,Clientes Churn
16454.0,44,2,6.9,2,1,1,4,Clientes Churn
16455.0,63,7,1841.18,2,3,3,8,Clientes VIP
16456.0,98,5,1407.32,1,2,3,6,Clientes Emergentes
16457.0,217,1,161.56,1,1,1,3,Clientes Churn
16458.0,2,18,3469.3,3,3,3,9,Clientes VIP
16460.0,27,3,729.49,2,2,2,6,Clientes Emergentes
16461.0,177,1,76.67,1,1,1,3,Clientes Churn
16463.0,20,4,1295.48,3,2,3,8,Clientes VIP
16464.0,19,3,1103.27,3,2,3,8,Clientes VIP
16466.0,33,7,1375.92,2,3,3,8,Clientes VIP
16469.0,23,4,548.18,3,2,2,7,Clientes Emergentes
16470.0,51,4,674.52,2,2,2,6,Clientes Emergentes
16471.0,274,1,223.95000000000002,1,1,1,3,Clientes Churn
16473.0,164,3,289.16,1,2,2,5,Clientes Emergentes
16474.0,6,6,1742.1000000000001,3,3,3,9,Clientes VIP
16475.0,143,3,417.7,1,2,2,5,Clientes Emergentes
16477.0,63,7,2450.7200000000003,2,3,3,8,Clientes VIP
16478.0,24,2,251.26000000000002,3,1,1,5,Clientes Emergentes
16479.0,9,2,255.63,3,1,1,5,Clientes Emergentes
16480.0,75,1,416.57,2,1,2,5,Clientes Emergentes
16482.0,15,1,167.34,3,1,1,5,Clientes Emergentes
16483.0,191,1,95.7,1,1,1,3,Clientes Churn
16484.0,173,2,376.8,1,1,2,4,Clientes Churn
16485.0,76,1,279.35,2,1,1,4,Clientes Churn
16488.0,32,3,290.3,2,2,2,6,Clientes Emergentes
16491.0,46,1,617.84,2,1,2,5,Clientes Emergentes
16493.0,79,4,1002.6,2,2,3,7,Clientes Emergentes
16494.0,296,1,723.93,1,1,2,4,Clientes Churn
16495.0,2,2,446.81,3,1,2,6,Clientes Emergentes
16496.0,8,3,1259.63,3,2,3,8,Clientes VIP
16497.0,49,6,2296.79,2,3,3,8,Clientes VIP
16498.0,160,2,93.02,1,1,1,3,Clientes Churn
16499.0,359,2,294.55,1,1,2,4,Clientes Churn
16500.0,4,5,235.86,3,2,1,6,Clientes Emergentes
16503.0,106,4,1124.28,1,2,3,6,Clientes Emergentes
16504.0,24,1,470.34,3,1,2,6,Clientes Emergentes
16506.0,19,2,90.30000000000001,3,1,1,5,Clientes Emergentes
16509.0,296,1,169.50000000000003,1,1,1,3,Clientes Churn
16510.0,371,1,178.54999999999998,1,1,1,3,Clientes Churn
16511.0,21,3,699.26,3,2,2,7,Clientes Emergentes
16513.0,4,4,874.59,3,2,3,8,Clientes VIP
16515.0,51,5,1370.53,2,2,3,7,Clientes Emergentes
16516.0,29,1,101.69999999999999,2,1,1,4,Clientes Churn
16517.0,276,1,154.75,1,1,1,3,Clientes Churn
16518.0,60,2,376.07,2,1,2,5,Clientes Emergentes
16519.0,24,2,74.38,3,1,1,5,Clientes Emergentes
16520.0,185,3,912.72,1,2,3,6,Clientes Emergentes
16523.0,1,19,4755.91,3,3,3,9,Clientes VIP
16525.0,1,26,4041.79,3,3,3,9,Clientes VIP
16526.0,171,1,237.66,1,1,1,3,Clientes Churn
16527.0,80,1,219.81,2,1,1,4,Clientes Churn
16528.0,3,1,175.02,3,1,1,5,Clientes Emergentes
16529.0,189,1,391.65000000000003,1,1,2,4,Clientes Churn
16531.0,21,7,1050.32,3,3,3,9,Clientes VIP
16533.0,18,3,896.97,3,2,3,8,Clientes VIP
16535.0,4,1,384.63,3,1,2,6,Clientes Emergentes
16536.0,109,1,357.02000000000004,1,1,2,4,Clientes Churn
16539.0,2,4,1372.91,3,2,3,8,Clientes VIP
16542.0,53,1,119.62,2,1,1,4,Clientes Churn
16545.0,164,1,101.7,1,1,1,3,Clientes Churn
16546.0,290,2,564.95,1,1,2,4,Clientes Churn
16549.0,9,10,3770.54,3,3,3,9,Clientes VIP
16550.0,108,5,1934.1000000000001,1,2,3,6,Clientes Emergentes
16551.0,95,3,426.38,1,2,2,5,Clientes Emergentes
16552.0,242,2,189.19000000000003,1,1,1,3,Clientes Churn
16553.0,204,6,977.24,1,3,3,7,Clientes Emergentes
16554.0,41,3,742.8,2,2,2,6,Clientes Emergentes
16555.0,34,2,269.39,2,1,1,4,Clientes Churn
16556.0,66,7,2316.6,2,3,3,8,Clientes VIP
16557.0,23,2,174.1,3,1,1,5,Clientes Emergentes
16558.0,0,20,6452.22,3,3,3,9,Clientes VIP
16560.0,26,2,652.66,2,1,2,5,Clientes Emergentes
16561.0,5,2,494.12,3,1,2,6,Clientes Emergentes
16563.0,53,1,324.5,2,1,2,5,Clientes Emergentes
16565.0,363,1,35.7,1,1,1,3,Clientes Churn
16566.0,14,5,287.28000000000003,3,2,2,7,Clientes Emergentes
16567.0,193,2,561.4,1,1,2,4,Clientes Churn
16569.0,2,1,76.5,3,1,1,5,Clientes Emergentes
16570.0,14,9,2176.71,3,3,3,9,Clientes VIP
16571.0,26,3,1249.37,2,2,3,7,Clientes Emergentes
16572.0,126,3,855.55,1,2,3,6,Clientes Emergentes
16573.0,84,2,525.96,2,1,2,5,Clientes Emergentes
16574.0,70,1,409.14,2,1,2,5,Clientes Emergentes
16581.0,182,1,105.84,1,1,1,3,Clientes Churn
16582.0,112,1,50.099999999999994,1,1,1,3,Clientes Churn
16583.0,373,1,233.45,1,1,1,3,Clientes Churn
16584.0,79,2,675.38,2,1,2,5,Clientes Emergentes
16586.0,248,1,361.95,1,1,2,4,Clientes Churn
16587.0,231,1,127.85000000000001,1,1,1,3,Clientes Churn
16589.0,70,3,459.24,2,2,2,6,Clientes Emergentes
16591.0,68,1,213.5,2,1,1,4,Clientes Churn
16592.0,3,16,3584.33,3,3,3,9,Clientes VIP
16593.0,50,2,104.47999999999999,2,1,1,4,Clientes Churn
16594.0,74,1,123.44,2,1,1,4,Clientes Churn
16595.0,60,1,341.96,2,1,2,5,Clientes Emergentes
16596.0,15,2,193.85000000000002,3,1,1,5,Clientes Emergentes
16597.0,3,1,44.24,3,1,1,5,Clientes Emergentes
16598.0,285,1,145.04999999999998,1,1,1,3,Clientes Churn
16600.0,3,6,658.1,3,3,2,8,Clientes VIP
16601.0,40,1,163.01,2,1,1,4,Clientes Churn
16602.0,35,1,497.21,2,1,2,5,Clientes Emergentes
16603.0,74,2,465.97,2,1,2,5,Clientes Emergentes
16607.0,17,12,2374.72,3,3,3,9,Clientes VIP
16609.0,14,7,4808.900000000001,3,3,3,9,Clientes VIP
16610.0,218,1,75.66,1,1,1,3,Clientes Churn
16611.0,185,1,129.49,1,1,1,3,Clientes Churn
16612.0,32,4,1036.76,2,2,3,7,Clientes Emergentes
16613.0,69,1,586.79,2,1,2,5,Clientes Emergentes
16614.0,182,1,305.79,1,1,2,4,Clientes Churn
16616.0,14,2,420.52,3,1,2,6,Clientes Emergentes
16617.0,235,1,79.1,1,1,1,3,Clientes Churn
16618.0,30,4,1561.08,2,2,3,7,Clientes Emergentes
16619.0,263,1,226.21,1,1,1,3,Clientes Churn
16620.0,3,2,144.96,3,1,1,5,Clientes Emergentes
16621.0,51,4,282.71000000000004,2,2,2,6,Clientes Emergentes
16623.0,245,1,129.45,1,1,1,3,Clientes Churn
16624.0,80,2,439.49,2,1,2,5,Clientes Emergentes
16625.0,274,1,300.68,1,1,2,4,Clientes Churn
16626.0,0,16,2337.14,3,3,3,9,Clientes VIP
16627.0,78,1,162.38,2,1,1,4,Clientes Churn
16628.0,29,5,1963.05,2,2,3,7,Clientes Emergentes
16629.0,73,2,338.05,2,1,2,5,Clientes Emergentes
16633.0,16,6,2259.55,3,3,3,9,Clientes VIP
16634.0,222,2,172.5,1,1,1,3,Clientes Churn
16637.0,31,4,921.76,2,2,3,7,Clientes Emergentes
16638.0,22,10,1125.55,3,3,3,9,Clientes VIP
16639.0,30,3,974.01,2,2,3,7,Clientes Emergentes
16641.0,105,1,123.38,1,1,1,3,Clientes Churn
16642.0,4,2,428.73,3,1,2,6,Clientes Emergentes
16643.0,245,1,401.31,1,1,2,4,Clientes Churn
16644.0,177,2,813.88,1,1,2,4,Clientes Churn
16647.0,169,2,142.42000000000002,1,1,1,3,Clientes Churn
16648.0,42,1,267.26,2,1,1,4,Clientes Churn
16650.0,71,1,430.38,2,1,2,5,Clientes Emergentes
16652.0,58,5,2879.15,2,2,3,7,Clientes Emergentes
16653.0,15,2,1043.31,3,1,3,7,Clientes Emergentes
16654.0,140,4,381.87,1,2,2,5,Clientes Emergentes
16655.0,17,6,2726.36,3,3,3,9,Clientes VIP
16656.0,21,12,1325.28,3,3,3,9,Clientes VIP
16657.0,9,4,815.65,3,2,2,7,Clientes Emergentes
16658.0,367,1,91.44,1,1,1,3,Clientes Churn
16659.0,188,1,20.4,1,1,1,3,Clientes Churn
16660.0,15,2,205.97,3,1,1,5,Clientes Emergentes
16665.0,361,1,39.25,1,1,1,3,Clientes Churn
16666.0,18,1,118.98,3,1,1,5,Clientes Emergentes
16667.0,67,2,472.93,2,1,2,5,Clientes Emergentes
16668.0,14,6,286.56,3,3,2,8,Clientes VIP
16669.0,23,3,1132.17,3,2,3,8,Clientes VIP
16670.0,16,11,3472.7200000000003,3,3,3,9,Clientes VIP
16671.0,35,1,81.75,2,1,1,4,Clientes Churn
16672.0,1,17,4005.3,3,3,3,9,Clientes VIP
16674.0,54,2,309.21,2,1,2,5,Clientes Emergentes
16676.0,33,4,1062.78,2,2,3,7,Clientes Emergentes
16678.0,2,12,2564.91,3,3,3,9,Clientes VIP
16679.0,365,1,117.0,1,1,1,3,Clientes Churn
16680.0,42,1,149.7,2,1,1,4,Clientes Churn
16681.0,77,5,939.64,2,2,3,7,Clientes Emergentes
16682.0,4,5,363.42,3,2,2,7,Clientes Emergentes
16684.0,3,8,1357.74,3,3,3,9,Clientes VIP
16685.0,60,1,227.82,2,1,1,4,Clientes Churn
16686.0,46,7,2376.23,2,3,3,8,Clientes VIP
16688.0,0,4,1000.88,3,2,3,8,Clientes VIP
16689.0,75,2,293.52,2,1,2,5,Clientes Emergentes
16690.0,71,2,156.43,2,1,1,4,Clientes Churn
16693.0,68,2,366.01,2,1,2,5,Clientes Emergentes
16696.0,134,4,462.3,1,2,2,5,Clientes Emergentes
16697.0,240,1,50.85,1,1,1,3,Clientes Churn
16700.0,8,13,4800.46,3,3,3,9,Clientes VIP
16701.0,8,12,2023.07,3,3,3,9,Clientes VIP
16705.0,0,20,6634.37,3,3,3,9,Clientes VIP
16706.0,36,3,398.1,2,2,2,6,Clientes Emergentes
16708.0,45,1,571.03,2,1,2,5,Clientes Emergentes
16709.0,84,5,1667.8300000000002,2,2,3,7,Clientes Emergentes
16710.0,18,10,2137.4900000000002,3,3,3,9,Clientes VIP
16711.0,2,3,273.03000000000003,3,2,1,6,Clientes Emergentes
16712.0,17,10,2557.6,3,3,3,9,Clientes VIP
16713.0,18,15,4720.2300000000005,3,3,3,9,Clientes VIP
16714.0,316,1,838.88,1,1,3,5,Clientes Emergentes
16715.0,77,1,99.39999999999999,2,1,1,4,Clientes Churn
16716.0,266,1,166.8,1,1,1,3,Clientes Churn
16717.0,23,6,3254.9300000000003,3,3,3,9,Clientes VIP
16718.0,368,1,500.63,1,1,2,4,Clientes Churn
16719.0,14,7,1284.17,3,3,3,9,Clientes VIP
16720.0,25,1,116.57,2,1,1,4,Clientes Churn
16721.0,261,1,292.47,1,1,2,4,Clientes Churn
16722.0,16,13,3271.29,3,3,3,9,Clientes VIP
16723.0,107,1,246.99,1,1,1,3,Clientes Churn
16725.0,301,7,602.6800000000001,1,3,2,6,Clientes Emergentes
16726.0,25,5,1155.43,2,2,3,7,Clientes Emergentes
16727.0,363,1,272.82,1,1,1,3,Clientes Churn
16728.0,45,4,845.17,2,2,3,7,Clientes Emergentes
16729.0,37,21,6386.43,2,3,3,8,Clientes VIP
16730.0,51,3,627.87,2,2,2,6,Clientes Emergentes
16732.0,31,1,540.33,2,1,2,5,Clientes Emergentes
16734.0,51,3,465.91,2,2,2,6,Clientes Emergentes
16735.0,78,5,2002.2,2,2,3,7,Clientes Emergentes
16738.0,297,1,3.75,1,1,1,3,Clientes Churn
16739.0,176,1,238.75,1,1,1,3,Clientes Churn
16743.0,28,7,2097.61,2,3,3,8,Clientes VIP
16744.0,10,7,1046.87,3,3,3,9,Clientes VIP
16745.0,86,17,4431.13,2,3,3,8,Clientes VIP
16746.0,4,18,5283.09,3,3,3,9,Clientes VIP
16747.0,37,2,590.73,2,1,2,5,Clientes Emergentes
16748.0,17,5,1515.9,3,2,3,8,Clientes VIP
16750.0,44,5,414.13,2,2,2,6,Clientes Emergentes
16751.0,30,1,216.01999999999998,2,1,1,4,Clientes Churn
16752.0,372,1,77.7,1,1,1,3,Clientes Churn
16753.0,57,1,198.92000000000002,2,1,1,4,Clientes Churn
16755.0,113,3,1177.94,1,2,3,6,Clientes Emergentes
16756.0,214,1,213.9,1,1,1,3,Clientes Churn
16757.0,318,1,106.83000000000001,1,1,1,3,Clientes Churn
16758.0,64,1,207.86,2,1,1,4,Clientes Churn
16759.0,7,3,643.1,3,2,2,7,Clientes Emergentes
16761.0,96,1,195.9,1,1,1,3,Clientes Churn
16762.0,19,3,1404.48,3,2,3,8,Clientes VIP
16763.0,198,1,287.45,1,1,2,4,Clientes Churn
16764.0,3,13,2547.15,3,3,3,9,Clientes VIP
16766.0,272,2,989.0,1,1,3,5,Clientes Emergentes
16767.0,30,10,3915.91,2,3,3,8,Clientes VIP
16768.0,47,3,223.69,2,2,1,5,Clientes Emergentes
16769.0,259,1,209.14000000000001,1,1,1,3,Clientes Churn
16770.0,57,5,696.0500000000001,2,2,2,6,Clientes Emergentes
16771.0,32,5,1823.39,2,2,3,7,Clientes Emergentes
16773.0,56,1,106.89,2,1,1,4,Clientes Churn
16774.0,67,4,590.12,2,2,2,6,Clientes Emergentes
16775.0,9,11,1275.26,3,3,3,9,Clientes VIP
16776.0,59,1,373.33,2,1,2,5,Clientes Emergentes
16777.0,79,2,138.05,2,1,1,4,Clientes Churn
16778.0,73,2,228.94,2,1,1,4,Clientes Churn
16779.0,1,22,7674.4800000000005,3,3,3,9,Clientes VIP
16780.0,99,2,389.74,1,1,2,4,Clientes Churn
16781.0,371,1,216.8,1,1,1,3,Clientes Churn
16782.0,9,13,1798.3000000000002,3,3,3,9,Clientes VIP
16784.0,19,1,107.6,3,1,1,5,Clientes Emergentes
16788.0,122,2,579.03,1,1,2,4,Clientes Churn
16789.0,7,1,80.8,3,1,1,5,Clientes Emergentes
16790.0,3,6,1485.38,3,3,3,9,Clientes VIP
16791.0,28,7,1430.38,2,3,3,8,Clientes VIP
16792.0,281,1,87.68,1,1,1,3,Clientes Churn
16793.0,56,1,226.84,2,1,1,4,Clientes Churn
16794.0,0,10,1143.05,3,3,3,9,Clientes VIP
16795.0,364,1,392.18,1,1,2,4,Clientes Churn
16796.0,88,1,305.62,2,1,2,5,Clientes Emergentes
16800.0,10,1,856.82,3,1,3,7,Clientes Emergentes
16801.0,162,4,909.53,1,2,3,6,Clientes Emergentes
16803.0,64,1,332.3,2,1,2,5,Clientes Emergentes
16804.0,22,3,445.84000000000003,3,2,2,7,Clientes Emergentes
16805.0,173,2,365.31,1,1,2,4,Clientes Churn
16806.0,102,4,637.99,1,2,2,5,Clientes Emergentes
16807.0,142,3,934.6899999999999,1,2,3,6,Clientes Emergentes
16808.0,98,2,222.97,1,1,1,3,Clientes Churn
16809.0,22,5,882.59,3,2,3,8,Clientes VIP
16810.0,191,1,289.64,1,1,2,4,Clientes Churn
16811.0,4,2,464.23,3,1,2,6,Clientes Emergentes
16812.0,360,1,204.15,1,1,1,3,Clientes Churn
16813.0,7,10,1426.37,3,3,3,9,Clientes VIP
16814.0,13,21,4975.78,3,3,3,9,Clientes VIP
16816.0,102,4,401.16,1,2,2,5,Clientes Emergentes
16817.0,2,9,1262.71,3,3,3,9,Clientes VIP
16818.0,10,11,3091.15,3,3,3,9,Clientes VIP
16820.0,95,1,415.94,1,1,2,4,Clientes Churn
16823.0,226,1,269.68,1,1,1,3,Clientes Churn
16824.0,15,2,402.74,3,1,2,6,Clientes Emergentes
16825.0,38,2,521.48,2,1,2,5,Clientes Emergentes
16826.0,50,1,279.45,2,1,2,5,Clientes Emergentes
16828.0,111,1,113.5,1,1,1,3,Clientes Churn
16829.0,156,1,181.32,1,1,1,3,Clientes Churn
16830.0,38,1,325.91,2,1,2,5,Clientes Emergentes
16832.0,216,1,39.0,1,1,1,3,Clientes Churn
16833.0,0,4,1021.53,3,2,3,8,Clientes VIP
16834.0,227,1,413.46,1,1,2,4,Clientes Churn
16835.0,127,2,133.15,1,1,1,3,Clientes Churn
16836.0,39,2,175.55,2,1,1,4,Clientes Churn
16837.0,30,9,2083.25,2,3,3,8,Clientes VIP
16838.0,196,2,353.9,1,1,2,4,Clientes Churn
16839.0,8,29,3731.29,3,3,3,9,Clientes VIP
16841.0,36,6,1692.7,2,3,3,8,Clientes VIP
16842.0,100,3,935.49,1,2,3,6,Clientes Emergentes
16843.0,42,16,7099.72,2,3,3,8,Clientes VIP
16846.0,49,1,197.82,2,1,1,4,Clientes Churn
16847.0,42,1,176.94,2,1,1,4,Clientes Churn
16848.0,52,1,281.42,2,1,2,5,Clientes Emergentes
16849.0,186,1,84.77,1,1,1,3,Clientes Churn
16850.0,333,1,317.29,1,1,2,4,Clientes Churn
16851.0,3,3,322.28999999999996,3,2,2,7,Clientes Emergentes
16852.0,9,2,70.96000000000001,3,1,1,5,Clientes Emergentes
16855.0,23,2,285.8,3,1,2,6,Clientes Emergentes
16856.0,14,1,35.400000000000006,3,1,1,5,Clientes Emergentes
16858.0,368,1,320.04,1,1,2,4,Clientes Churn
16859.0,144,2,587.63,1,1,2,4,Clientes Churn
16861.0,59,2,112.80000000000001,2,1,1,4,Clientes Churn
16863.0,30,2,438.88,2,1,2,5,Clientes Emergentes
16866.0,140,3,108.24000000000001,1,2,1,4,Clientes Churn
16869.0,22,4,699.09,3,2,2,7,Clientes Emergentes
16871.0,21,6,2267.2400000000002,3,3,3,9,Clientes VIP
16873.0,4,6,5218.74,3,3,3,9,Clientes VIP
16875.0,66,5,1643.83,2,2,3,7,Clientes Emergentes
16877.0,11,6,779.87,3,3,2,8,Clientes VIP
16878.0,83,1,13.3,2,1,1,4,Clientes Churn
16880.0,30,7,821.12,2,3,2,7,Clientes Emergentes
16882.0,66,3,529.47,2,2,2,6,Clientes Emergentes
16883.0,186,2,213.03,1,1,1,3,Clientes Churn
16884.0,37,2,399.96,2,1,2,5,Clientes Emergentes
16885.0,14,3,338.41,3,2,2,7,Clientes Emergentes
16887.0,34,1,170.13,2,1,1,4,Clientes Churn
16889.0,194,3,1273.84,1,2,3,6,Clientes Emergentes
16891.0,1,5,653.7,3,2,2,7,Clientes Emergentes
16892.0,0,5,375.34,3,2,2,7,Clientes Emergentes
16893.0,366,1,126.03,1,1,1,3,Clientes Churn
16895.0,64,1,191.99,2,1,1,4,Clientes Churn
16897.0,298,2,154.23000000000002,1,1,1,3,Clientes Churn
16898.0,25,3,449.32,2,2,2,6,Clientes Emergentes
16899.0,7,6,812.11,3,3,2,8,Clientes VIP
16900.0,16,3,753.9,3,2,2,7,Clientes Emergentes
16902.0,115,1,1094.69,1,1,3,5,Clientes Emergentes
16903.0,28,1,336.84,2,1,2,5,Clientes Emergentes
16904.0,3,14,2712.55,3,3,3,9,Clientes VIP
16905.0,4,7,2084.34,3,3,3,9,Clientes VIP
16906.0,81,4,344.26,2,2,2,6,Clientes Emergentes
16907.0,28,5,768.2,2,2,2,6,Clientes Emergentes
16909.0,71,1,213.72,2,1,1,4,Clientes Churn
16910.0,3,8,1137.51,3,3,3,9,Clientes VIP
16912.0,28,11,1710.88,2,3,3,8,Clientes VIP
16913.0,289,1,53.44,1,1,1,3,Clientes Churn
16914.0,35,1,128.61,2,1,1,4,Clientes Churn
16915.0,8,5,305.63,3,2,2,7,Clientes Emergentes
16916.0,23,2,512.03,3,1,2,6,Clientes Emergentes
16917.0,276,1,121.9,1,1,1,3,Clientes Churn
16918.0,49,6,923.52,2,3,3,8,Clientes VIP
16919.0,155,11,1597.0,1,3,3,7,Clientes Emergentes
16921.0,60,1,161.54,2,1,1,4,Clientes Churn
16923.0,11,17,5390.79,3,3,3,9,Clientes VIP
16924.0,20,3,698.25,3,2,2,7,Clientes Emergentes
16926.0,370,1,33.45,1,1,1,3,Clientes Churn
16927.0,275,2,139.85,1,1,1,3,Clientes Churn
16928.0,79,17,1900.12,2,3,3,8,Clientes VIP
16929.0,3,7,1211.81,3,3,3,9,Clientes VIP
16930.0,25,3,293.83,2,2,2,6,Clientes Emergentes
16931.0,4,21,4214.75,3,3,3,9,Clientes VIP
16932.0,52,1,145.44,2,1,1,4,Clientes Churn
16933.0,0,2,452.36,3,1,2,6,Clientes Emergentes
16934.0,54,2,786.38,2,1,2,5,Clientes Emergentes
16936.0,25,1,246.89000000000001,2,1,1,4,Clientes Churn
16938.0,8,4,1737.19,3,2,3,8,Clientes VIP
16940.0,51,3,2879.89,2,2,3,7,Clientes Emergentes
16942.0,12,9,1519.79,3,3,3,9,Clientes VIP
16943.0,211,3,431.18,1,2,2,5,Clientes Emergentes
16945.0,21,19,4126.04,3,3,3,9,Clientes VIP
16947.0,235,1,339.48,1,1,2,4,Clientes Churn
16948.0,138,3,212.9,1,2,1,4,Clientes Churn
16949.0,3,6,674.72,3,3,2,8,Clientes VIP
16950.0,56,3,741.3000000000001,2,2,2,6,Clientes Emergentes
16951.0,134,3,1125.06,1,2,3,6,Clientes Emergentes
16952.0,108,2,101.75999999999999,1,1,1,3,Clientes Churn
16953.0,29,1,20.8,2,1,1,4,Clientes Churn
16954.0,0,7,1026.71,3,3,3,9,Clientes VIP
16955.0,184,4,373.87,1,2,2,5,Clientes Emergentes
16956.0,17,1,225.04,3,1,1,5,Clientes Emergentes
16957.0,238,2,376.84000000000003,1,1,2,4,Clientes Churn
16959.0,86,1,117.35000000000001,2,1,1,4,Clientes Churn
16960.0,38,3,488.6,2,2,2,6,Clientes Emergentes
16961.0,115,1,234.17,1,1,1,3,Clientes Churn
16963.0,186,1,110.55000000000001,1,1,1,3,Clientes Churn
16965.0,226,1,117.4,1,1,1,3,Clientes Churn
16966.0,44,2,116.05,2,1,1,4,Clientes Churn
16967.0,188,1,305.09999999999997,1,1,2,4,Clientes Churn
16968.0,3,2,370.73,3,1,2,6,Clientes Emergentes
16969.0,38,3,522.2,2,2,2,6,Clientes Emergentes
16971.0,37,1,116.21,2,1,1,4,Clientes Churn
16978.0,77,1,294.43,2,1,2,5,Clientes Emergentes
16979.0,3,6,1137.33,3,3,3,9,Clientes VIP
16980.0,254,2,789.01,1,1,2,4,Clientes Churn
16982.0,60,1,384.06,2,1,2,5,Clientes Emergentes
16983.0,12,7,1540.13,3,3,3,9,Clientes VIP
16984.0,87,2,2956.29,2,1,3,6,Clientes Emergentes
16985.0,16,9,3875.84,3,3,3,9,Clientes VIP
16986.0,29,1,20.8,2,1,1,4,Clientes Churn
16987.0,2,6,879.6,3,3,3,9,Clientes VIP
16988.0,4,1,67.87,3,1,1,5,Clientes Emergentes
16989.0,6,3,110.54999999999998,3,2,1,6,Clientes Emergentes
16992.0,10,5,1302.16,3,2,3,8,Clientes VIP
16996.0,29,6,1335.2800000000002,2,3,3,8,Clientes VIP
16997.0,287,2,117.0,1,1,1,3,Clientes Churn
16998.0,149,3,105.4,1,2,1,4,Clientes Churn
16999.0,22,2,289.92,3,1,2,6,Clientes Emergentes
17001.0,0,11,3317.16,3,3,3,9,Clientes VIP
17002.0,85,3,801.3,2,2,2,6,Clientes Emergentes
17004.0,45,2,665.64,2,1,2,5,Clientes Emergentes
17006.0,4,4,703.9300000000001,3,2,2,7,Clientes Emergentes
17007.0,50,6,675.91,2,3,2,7,Clientes Emergentes
17010.0,17,1,171.96,3,1,1,5,Clientes Emergentes
17011.0,29,1,270.9,2,1,1,4,Clientes Churn
17014.0,7,3,487.88,3,2,2,7,Clientes Emergentes
17015.0,28,3,1747.79,2,2,3,7,Clientes Emergentes
17017.0,2,19,5224.44,3,3,3,9,Clientes VIP
17018.0,40,2,748.5,2,1,2,5,Clientes Emergentes
17019.0,10,4,1129.81,3,2,3,8,Clientes VIP
17022.0,30,1,71.0,2,1,1,4,Clientes Churn
17024.0,44,3,95.85,2,2,1,5,Clientes Emergentes
17025.0,60,3,236.45,2,2,1,5,Clientes Emergentes
17026.0,369,1,20.4,1,1,1,3,Clientes Churn
17027.0,78,6,830.99,2,3,3,8,Clientes VIP
17030.0,63,1,115.95,2,1,1,4,Clientes Churn
17031.0,11,2,317.95,3,1,2,6,Clientes Emergentes
17033.0,85,3,617.76,2,2,2,6,Clientes Emergentes
17034.0,15,3,585.07,3,2,2,7,Clientes Emergentes
17035.0,245,2,347.08,1,1,2,4,Clientes Churn
17037.0,87,1,1182.32,2,1,3,6,Clientes Emergentes
17038.0,29,1,88.25,2,1,1,4,Clientes Churn
17040.0,137,1,159.78,1,1,1,3,Clientes Churn
17041.0,26,3,964.65,2,2,3,7,Clientes Emergentes
17042.0,2,5,967.48,3,2,3,8,Clientes VIP
17043.0,31,4,1144.98,2,2,3,7,Clientes Emergentes
17045.0,112,2,210.24,1,1,1,3,Clientes Churn
17046.0,156,1,248.6,1,1,1,3,Clientes Churn
17047.0,84,3,882.9,2,2,3,7,Clientes Emergentes
17048.0,117,3,772.25,1,2,2,5,Clientes Emergentes
17049.0,2,9,4305.34,3,3,3,9,Clientes VIP
17050.0,95,6,2667.04,1,3,3,7,Clientes Emergentes
17051.0,193,1,237.19,1,1,1,3,Clientes Churn
17052.0,27,1,364.74,2,1,2,5,Clientes Emergentes
17053.0,130,1,373.08000000000004,1,1,2,4,Clientes Churn
17054.0,27,5,795.28,2,2,2,6,Clientes Emergentes
17058.0,81,3,965.54,2,2,3,7,Clientes Emergentes
17059.0,29,5,2563.81,2,2,3,7,Clientes Emergentes
17060.0,265,1,50.400000000000006,1,1,1,3,Clientes Churn
17061.0,73,7,1653.0,2,3,3,8,Clientes VIP
17062.0,313,4,498.08,1,2,2,5,Clientes Emergentes
17063.0,20,7,1276.7,3,3,3,9,Clientes VIP
17064.0,58,3,685.2,2,2,2,6,Clientes Emergentes
17068.0,11,21,4238.99,3,3,3,9,Clientes VIP
17069.0,27,9,2422.9500000000003,2,3,3,8,Clientes VIP
17070.0,113,1,292.24,1,1,2,4,Clientes Churn
17071.0,27,9,1836.0800000000002,2,3,3,8,Clientes VIP
17073.0,17,4,1143.02,3,2,3,8,Clientes VIP
17075.0,17,4,624.52,3,2,2,7,Clientes Emergentes
17076.0,35,3,386.9599999999999,2,2,2,6,Clientes Emergentes
17078.0,35,2,262.28,2,1,1,4,Clientes Churn
17079.0,77,1,118.80000000000001,2,1,1,4,Clientes Churn
17080.0,21,1,125.39999999999999,3,1,1,5,Clientes Emergentes
17081.0,24,2,211.76,3,1,1,5,Clientes Emergentes
17082.0,32,2,1408.1,2,1,3,6,Clientes Emergentes
17083.0,108,3,1219.0,1,2,3,6,Clientes Emergentes
17084.0,34,2,2289.9,2,1,3,6,Clientes Emergentes
17085.0,122,5,1370.95,1,2,3,6,Clientes Emergentes
17086.0,6,6,1307.9,3,3,3,9,Clientes VIP
17088.0,27,4,1651.6100000000001,2,2,3,7,Clientes Emergentes
17090.0,3,5,1416.04,3,2,3,8,Clientes VIP
17091.0,2,9,3421.37,3,3,3,9,Clientes VIP
17092.0,49,4,1638.19,2,2,3,7,Clientes Emergentes
17094.0,321,1,254.3,1,1,1,3,Clientes Churn
17095.0,22,3,1184.91,3,2,3,8,Clientes VIP
17096.0,14,4,771.84,3,2,2,7,Clientes Emergentes
17097.0,1,8,799.72,3,3,2,8,Clientes VIP
17100.0,17,2,948.34,3,1,3,7,Clientes Emergentes
17101.0,29,3,1067.18,2,2,3,7,Clientes Emergentes
17105.0,158,2,560.98,1,1,2,4,Clientes Churn
17107.0,32,6,7844.23,2,3,3,8,Clientes VIP
17109.0,28,6,816.7,2,3,2,7,Clientes Emergentes
17110.0,164,1,76.1,1,1,1,3,Clientes Churn
17111.0,46,1,200.39000000000001,2,1,1,4,Clientes Churn
17114.0,5,8,442.17,3,3,2,8,Clientes VIP
17115.0,7,3,563.7,3,2,2,7,Clientes Emergentes
17117.0,287,1,73.35,1,1,1,3,Clientes Churn
17118.0,317,1,157.02,1,1,1,3,Clientes Churn
17119.0,2,2,477.79,3,1,2,6,Clientes Emergentes
17120.0,232,1,222.96,1,1,1,3,Clientes Churn
17122.0,118,1,138.32,1,1,1,3,Clientes Churn
17123.0,161,1,263.7,1,1,1,3,Clientes Churn
17124.0,184,1,267.09000000000003,1,1,1,3,Clientes Churn
17125.0,49,1,175.13,2,1,1,4,Clientes Churn
17126.0,151,5,932.46,1,2,3,6,Clientes Emergentes
17128.0,334,1,131.59,1,1,1,3,Clientes Churn
17131.0,4,4,1839.1200000000001,3,2,3,8,Clientes VIP
17133.0,15,3,32.400000000000006,3,2,1,6,Clientes Emergentes
17134.0,106,2,244.15,1,1,1,3,Clientes Churn
17135.0,15,5,635.77,3,2,2,7,Clientes Emergentes
17138.0,275,1,288.3,1,1,2,4,Clientes Churn
17139.0,15,12,7858.57,3,3,3,9,Clientes VIP
17140.0,246,1,126.62,1,1,1,3,Clientes Churn
17142.0,238,1,119.7,1,1,1,3,Clientes Churn
17144.0,0,2,537.1800000000001,3,1,2,6,Clientes Emergentes
17146.0,262,2,400.98,1,1,2,4,Clientes Churn
17147.0,22,4,1270.07,3,2,3,8,Clientes VIP
17148.0,51,1,124.88,2,1,1,4,Clientes Churn
17152.0,194,3,408.8,1,2,2,5,Clientes Emergentes
17153.0,23,1,213.78,3,1,1,5,Clientes Emergentes
17154.0,74,1,299.1,2,1,2,5,Clientes Emergentes
17155.0,17,2,78.2,3,1,1,5,Clientes Emergentes
17157.0,7,2,319.0,3,1,2,6,Clientes Emergentes
17158.0,31,3,954.77,2,2,3,7,Clientes Emergentes
17159.0,21,3,1436.45,3,2,3,8,Clientes VIP
17160.0,30,6,3356.97,2,3,3,8,Clientes VIP
17162.0,28,10,1293.26,2,3,3,8,Clientes VIP
17163.0,21,2,293.1,3,1,2,6,Clientes Emergentes
17164.0,32,7,2336.2,2,3,3,8,Clientes VIP
17165.0,283,1,122.88,1,1,1,3,Clientes Churn
17166.0,38,2,206.34,2,1,1,4,Clientes Churn
17169.0,57,2,751.76,2,1,2,5,Clientes Emergentes
17171.0,288,1,199.41,1,1,1,3,Clientes Churn
17172.0,78,1,224.28,2,1,1,4,Clientes Churn
17173.0,4,8,3226.9,3,3,3,9,Clientes VIP
17174.0,217,1,59.9,1,1,1,3,Clientes Churn
17175.0,43,4,968.98,2,2,3,7,Clientes Emergentes
17176.0,201,1,208.03,1,1,1,3,Clientes Churn
17179.0,177,3,701.84,1,2,2,5,Clientes Emergentes
17180.0,55,4,673.12,2,2,2,6,Clientes Emergentes
17181.0,56,1,44.6,2,1,1,4,Clientes Churn
17183.0,7,6,2326.41,3,3,3,9,Clientes VIP
17187.0,226,1,114.35,1,1,1,3,Clientes Churn
17188.0,10,7,1430.71,3,3,3,9,Clientes VIP
17189.0,105,2,265.55,1,1,1,3,Clientes Churn
17190.0,58,1,228.74,2,1,1,4,Clientes Churn
17191.0,27,7,1797.01,2,3,3,8,Clientes VIP
17193.0,35,7,1088.8600000000001,2,3,3,8,Clientes VIP
17194.0,360,1,76.12,1,1,1,3,Clientes Churn
17197.0,29,1,463.81,2,1,2,5,Clientes Emergentes
17198.0,23,3,354.97,3,2,2,7,Clientes Emergentes
17201.0,53,1,155.73,2,1,1,4,Clientes Churn
17203.0,35,6,902.81,2,3,3,8,Clientes VIP
17204.0,174,4,1091.3600000000001,1,2,3,6,Clientes Emergentes
17205.0,53,1,20.5,2,1,1,4,Clientes Churn
17206.0,52,1,204.24,2,1,1,4,Clientes Churn
17211.0,26,8,1798.93,2,3,3,8,Clientes VIP
17212.0,252,1,3.95,1,1,1,3,Clientes Churn
17213.0,39,7,2176.2000000000003,2,3,3,8,Clientes VIP
17214.0,59,6,730.07,2,3,2,7,Clientes Emergentes
17217.0,233,1,97.6,1,1,1,3,Clientes Churn
17218.0,3,10,1563.63,3,3,3,9,Clientes VIP
17219.0,31,1,105.98,2,1,1,4,Clientes Churn
17220.0,23,14,2796.43,3,3,3,9,Clientes VIP
17221.0,6,2,246.31,3,1,1,5,Clientes Emergentes
17222.0,64,1,298.5,2,1,2,5,Clientes Emergentes
17223.0,309,2,234.99,1,1,1,3,Clientes Churn
17226.0,308,1,148.99,1,1,1,3,Clientes Churn
17227.0,18,6,369.86,3,3,2,8,Clientes VIP
17228.0,15,8,1798.95,3,3,3,9,Clientes VIP
17229.0,95,2,308.81,1,1,2,4,Clientes Churn
17230.0,263,6,1514.0,1,3,3,7,Clientes Emergentes
17231.0,11,10,2685.82,3,3,3,9,Clientes VIP
17232.0,2,2,421.52,3,1,2,6,Clientes Emergentes
17233.0,34,1,131.07,2,1,1,4,Clientes Churn
17234.0,182,1,114.04,1,1,1,3,Clientes Churn
17235.0,24,2,357.46,3,1,2,6,Clientes Emergentes
17236.0,12,6,787.58,3,3,2,8,Clientes VIP
17237.0,10,2,306.74,3,1,2,6,Clientes Emergentes
17238.0,2,17,3303.65,3,3,3,9,Clientes VIP
17239.0,312,1,295.0,1,1,2,4,Clientes Churn
17242.0,107,2,915.04,1,1,3,5,Clientes Emergentes
17243.0,0,26,5859.9400000000005,3,3,3,9,Clientes VIP
17244.0,52,1,532.53,2,1,2,5,Clientes Emergentes
17245.0,204,1,171.45,1,1,1,3,Clientes Churn
17247.0,14,1,208.09,3,1,1,5,Clientes Emergentes
17248.0,119,1,277.85,1,1,1,3,Clientes Churn
17250.0,3,2,285.17,3,1,2,6,Clientes Emergentes
17251.0,362,1,249.28,1,1,1,3,Clientes Churn
17252.0,116,2,299.26,1,1,2,4,Clientes Churn
17253.0,17,1,113.01,3,1,1,5,Clientes Emergentes
17254.0,4,2,236.29,3,1,1,5,Clientes Emergentes
17255.0,40,2,260.38,2,1,1,4,Clientes Churn
17256.0,106,2,150.29999999999998,1,1,1,3,Clientes Churn
17259.0,147,2,507.47,1,1,2,4,Clientes Churn
17262.0,51,3,391.81,2,2,2,6,Clientes Emergentes
17263.0,207,1,63.440000000000005,1,1,1,3,Clientes Churn
17265.0,138,2,510.1,1,1,2,4,Clientes Churn
17266.0,1,3,240.09,3,2,1,6,Clientes Emergentes
17267.0,126,2,209.77,1,1,1,3,Clientes Churn
17268.0,149,1,35.0,1,1,1,3,Clientes Churn
17272.0,45,3,1868.67,2,2,3,7,Clientes Emergentes
17274.0,34,1,85.42,2,1,1,4,Clientes Churn
17277.0,227,2,958.0500000000001,1,1,3,5,Clientes Emergentes
17278.0,240,1,206.09,1,1,1,3,Clientes Churn
17279.0,57,1,25.43,2,1,1,4,Clientes Churn
17282.0,173,2,373.2,1,1,2,4,Clientes Churn
17284.0,59,6,1591.18,2,3,3,8,Clientes VIP
17286.0,21,1,145.42,3,1,1,5,Clientes Emergentes
17287.0,25,7,709.51,2,3,2,7,Clientes Emergentes
17288.0,8,6,799.45,3,3,2,8,Clientes VIP
17289.0,31,3,890.96,2,2,3,7,Clientes Emergentes
17290.0,3,2,422.72,3,1,2,6,Clientes Emergentes
17293.0,7,8,1408.19,3,3,3,9,Clientes VIP
17295.0,28,3,400.12,2,2,2,6,Clientes Emergentes
17297.0,16,1,95.43,3,1,1,5,Clientes Emergentes
17298.0,100,2,270.68,1,1,1,3,Clientes Churn
17299.0,11,4,544.75,3,2,2,7,Clientes Emergentes
17301.0,20,1,166.43,3,1,1,5,Clientes Emergentes
17302.0,14,5,1044.48,3,2,3,8,Clientes VIP
17303.0,360,1,192.24,1,1,1,3,Clientes Churn
17306.0,10,3,109.92,3,2,1,6,Clientes Emergentes
17309.0,94,1,82.75,1,1,1,3,Clientes Churn
17311.0,77,2,727.84,2,1,2,5,Clientes Emergentes
17312.0,154,2,96.35000000000001,1,1,1,3,Clientes Churn
17313.0,30,1,210.60000000000002,2,1,1,4,Clientes Churn
17314.0,24,8,2036.24,3,3,3,9,Clientes VIP
17315.0,1,36,4215.72,3,3,3,9,Clientes VIP
17320.0,99,3,815.88,1,2,2,5,Clientes Emergentes
17321.0,67,1,430.44,2,1,2,5,Clientes Emergentes
17323.0,14,7,921.07,3,3,3,9,Clientes VIP
17324.0,17,4,418.59000000000003,3,2,2,7,Clientes Emergentes
17325.0,279,1,96.8,1,1,1,3,Clientes Churn
17329.0,13,2,466.56,3,1,2,6,Clientes Emergentes
17330.0,22,2,273.9,3,1,1,5,Clientes Emergentes
17333.0,85,1,479.13,2,1,2,5,Clientes Emergentes
17334.0,301,2,215.82,1,1,1,3,Clientes Churn
17337.0,150,4,1657.22,1,2,3,6,Clientes Emergentes
17338.0,16,8,5940.0,3,3,3,9,Clientes VIP
17339.0,93,2,199.20000000000002,1,1,1,3,Clientes Churn
17340.0,29,11,8982.7,2,3,3,8,Clientes VIP
17341.0,156,3,615.37,1,2,2,5,Clientes Emergentes
17343.0,354,1,168.74,1,1,1,3,Clientes Churn
17344.0,45,1,135.57,2,1,1,4,Clientes Churn
17345.0,14,4,393.79,3,2,2,7,Clientes Emergentes
17346.0,3,15,2271.4700000000003,3,3,3,9,Clientes VIP
17348.0,14,5,990.68,3,2,3,8,Clientes VIP
17349.0,178,1,47.55,1,1,1,3,Clientes Churn
17350.0,7,4,956.75,3,2,3,8,Clientes VIP
17351.0,35,3,253.5,2,2,1,5,Clientes Emergentes
17354.0,50,1,56.690000000000005,2,1,1,4,Clientes Churn
17356.0,311,1,178.22,1,1,1,3,Clientes Churn
17357.0,23,2,334.79,3,1,2,6,Clientes Emergentes
17358.0,302,2,347.40000000000003,1,1,2,4,Clientes Churn
17359.0,10,1,56.15,3,1,1,5,Clientes Emergentes
17360.0,16,3,504.34,3,2,2,7,Clientes Emergentes
17361.0,48,3,430.85,2,2,2,6,Clientes Emergentes
17362.0,238,2,276.28,1,1,1,3,Clientes Churn
17364.0,0,11,3659.7400000000002,3,3,3,9,Clientes VIP
17365.0,12,8,3828.03,3,3,3,9,Clientes VIP
17367.0,237,1,149.46,1,1,1,3,Clientes Churn
17368.0,22,7,647.79,3,3,2,8,Clientes VIP
17370.0,72,4,398.21999999999997,2,2,2,6,Clientes Emergentes
17371.0,16,3,210.64,3,2,1,6,Clientes Emergentes
17372.0,40,8,1232.8,2,3,3,8,Clientes VIP
17373.0,39,4,623.07,2,2,2,6,Clientes Emergentes
17374.0,218,2,109.07000000000001,1,1,1,3,Clientes Churn
17375.0,198,3,333.06,1,2,2,5,Clientes Emergentes
17376.0,70,2,185.0,2,1,1,4,Clientes Churn
17377.0,23,20,3527.02,3,3,3,9,Clientes VIP
17379.0,10,1,350.26,3,1,2,6,Clientes Emergentes
17381.0,151,5,632.31,1,2,2,5,Clientes Emergentes
17382.0,64,1,50.400000000000006,2,1,1,4,Clientes Churn
17383.0,3,1,199.29,3,1,1,5,Clientes Emergentes
17384.0,18,2,122.2,3,1,1,5,Clientes Emergentes
17385.0,14,1,251.16,3,1,1,5,Clientes Emergentes
17386.0,7,3,154.70000000000002,3,2,1,6,Clientes Emergentes
17387.0,19,2,629.12,3,1,2,6,Clientes Emergentes
17388.0,77,2,128.48,2,1,1,4,Clientes Churn
17389.0,0,26,2717.48,3,3,3,9,Clientes VIP
17392.0,306,2,355.26,1,1,2,4,Clientes Churn
17394.0,218,1,38.4,1,1,1,3,Clientes Churn
17396.0,148,2,108.75,1,1,1,3,Clientes Churn
17397.0,21,2,547.36,3,1,2,6,Clientes Emergentes
17398.0,114,3,378.78000000000003,1,2,2,5,Clientes Emergentes
17400.0,125,5,1565.24,1,2,3,6,Clientes Emergentes
17402.0,4,9,619.91,3,3,2,8,Clientes VIP
17403.0,35,1,255.87,2,1,1,4,Clientes Churn
17404.0,25,8,1172.14,2,3,3,8,Clientes VIP
17405.0,0,3,754.26,3,2,2,7,Clientes Emergentes
17406.0,332,2,1176.67,1,1,3,5,Clientes Emergentes
17409.0,184,2,111.55000000000001,1,1,1,3,Clientes Churn
17410.0,15,5,900.27,3,2,3,8,Clientes VIP
17411.0,11,3,630.7,3,2,2,7,Clientes Emergentes
17412.0,2,7,1178.74,3,3,3,9,Clientes VIP
17414.0,184,1,28.0,1,1,1,3,Clientes Churn
17415.0,79,1,138.44,2,1,1,4,Clientes Churn
17416.0,29,6,4601.58,2,3,3,8,Clientes VIP
17418.0,41,2,349.76,2,1,2,5,Clientes Emergentes
17419.0,10,12,3475.62,3,3,3,9,Clientes VIP
17420.0,49,3,485.08,2,2,2,6,Clientes Emergentes
17422.0,15,6,1609.85,3,3,3,9,Clientes VIP
17423.0,45,2,425.29,2,1,2,5,Clientes Emergentes
17425.0,60,1,655.97,2,1,2,5,Clientes Emergentes
17426.0,7,6,3895.29,3,3,3,9,Clientes VIP
17427.0,71,1,100.8,2,1,1,4,Clientes Churn
17428.0,0,25,5667.59,3,3,3,9,Clientes VIP
17429.0,127,3,401.72,1,2,2,5,Clientes Emergentes
17430.0,32,2,242.36,2,1,1,4,Clientes Churn
17431.0,312,1,357.4,1,1,2,4,Clientes Churn
17432.0,17,2,349.36,3,1,2,6,Clientes Emergentes
17433.0,87,1,283.26,2,1,2,5,Clientes Emergentes
17434.0,1,7,2021.72,3,3,3,9,Clientes VIP
17436.0,1,2,216.29999999999998,3,1,1,5,Clientes Emergentes
17438.0,253,1,283.05,1,1,2,4,Clientes Churn
17440.0,247,2,22.62,1,1,1,3,Clientes Churn
17442.0,36,6,2100.79,2,3,3,8,Clientes VIP
17444.0,151,2,1789.94,1,1,3,5,Clientes Emergentes
17446.0,176,2,120.9,1,1,1,3,Clientes Churn
17447.0,39,2,541.53,2,1,2,5,Clientes Emergentes
17449.0,1,7,2158.96,3,3,3,9,Clientes VIP
17450.0,10,9,2545.34,3,3,3,9,Clientes VIP
17451.0,0,7,1638.8,3,3,3,9,Clientes VIP
17453.0,17,2,457.46999999999997,3,1,2,6,Clientes Emergentes
17454.0,191,4,451.88,1,2,2,5,Clientes Emergentes
17455.0,203,1,111.8,1,1,1,3,Clientes Churn
17456.0,364,1,219.62,1,1,1,3,Clientes Churn
17457.0,126,4,216.49,1,2,1,4,Clientes Churn
17458.0,14,1,300.40000000000003,3,1,2,6,Clientes Emergentes
17459.0,42,2,551.99,2,1,2,5,Clientes Emergentes
17460.0,93,5,534.08,1,2,2,5,Clientes Emergentes
17461.0,22,3,633.65,3,2,2,7,Clientes Emergentes
17462.0,59,2,612.44,2,1,2,5,Clientes Emergentes
17463.0,15,5,1661.8600000000001,3,2,3,8,Clientes VIP
17464.0,157,1,248.20000000000002,1,1,1,3,Clientes Churn
17466.0,9,2,531.88,3,1,2,6,Clientes Emergentes
17468.0,9,2,137.0,3,1,1,5,Clientes Emergentes
17469.0,15,5,1695.97,3,2,3,8,Clientes VIP
17470.0,44,5,734.41,2,2,2,6,Clientes Emergentes
17472.0,190,3,668.89,1,2,2,5,Clientes Emergentes
17475.0,78,1,194.37,2,1,1,4,Clientes Churn
17480.0,77,1,511.82,2,1,2,5,Clientes Emergentes
17481.0,3,4,1091.96,3,2,3,8,Clientes VIP
17483.0,64,3,381.64,2,2,2,6,Clientes Emergentes
17486.0,260,1,376.97,1,1,2,4,Clientes Churn
17489.0,58,2,361.52,2,1,2,5,Clientes Emergentes
17490.0,0,7,1169.33,3,3,3,9,Clientes VIP
17491.0,0,10,2138.03,3,3,3,9,Clientes VIP
17492.0,247,1,288.62,1,1,2,4,Clientes Churn
17495.0,7,2,432.26,3,1,2,6,Clientes Emergentes
17496.0,358,1,251.10000000000002,1,1,1,3,Clientes Churn
17498.0,75,1,235.74,2,1,1,4,Clientes Churn
17499.0,289,1,460.1,1,1,2,4,Clientes Churn
17501.0,220,2,259.35,1,1,1,3,Clientes Churn
17502.0,8,4,633.36,3,2,2,7,Clientes Emergentes
17503.0,2,2,478.91,3,1,2,6,Clientes Emergentes
17504.0,205,9,1794.82,1,3,3,7,Clientes Emergentes
17505.0,161,2,1006.94,1,1,3,5,Clientes Emergentes
17506.0,75,1,302.2,2,1,2,5,Clientes Emergentes
17507.0,261,2,574.73,1,1,2,4,Clientes Churn
17508.0,280,1,387.31,1,1,2,4,Clientes Churn
17509.0,57,8,6115.14,2,3,3,8,Clientes VIP
17510.0,24,1,282.98,3,1,2,6,Clientes Emergentes
17511.0,2,28,12117.42,3,3,3,9,Clientes VIP
17512.0,50,8,1702.6100000000001,2,3,3,8,Clientes VIP
17513.0,71,1,140.39999999999998,2,1,1,4,Clientes Churn
17514.0,127,1,200.15,1,1,1,3,Clientes Churn
17515.0,30,4,403.17,2,2,2,6,Clientes Emergentes
17516.0,14,5,654.91,3,2,2,7,Clientes Emergentes
17517.0,308,1,128.44,1,1,1,3,Clientes Churn
17519.0,16,6,1151.1000000000001,3,3,3,9,Clientes VIP
17520.0,53,1,441.29,2,1,2,5,Clientes Emergentes
17521.0,29,3,684.59,2,2,2,6,Clientes Emergentes
17522.0,1,5,649.76,3,2,2,7,Clientes Emergentes
17523.0,10,2,263.43,3,1,1,5,Clientes Emergentes
17524.0,360,1,145.0,1,1,1,3,Clientes Churn
17525.0,359,1,295.5,1,1,2,4,Clientes Churn
17526.0,4,3,155.20000000000002,3,2,1,6,Clientes Emergentes
17527.0,53,4,712.4200000000001,2,2,2,6,Clientes Emergentes
17528.0,0,8,2755.06,3,3,3,9,Clientes VIP
17530.0,0,10,2098.42,3,3,3,9,Clientes VIP
17531.0,189,1,233.1,1,1,1,3,Clientes Churn
17534.0,53,1,223.36,2,1,1,4,Clientes Churn
17535.0,279,1,164.4,1,1,1,3,Clientes Churn
17537.0,29,2,777.16,2,1,2,5,Clientes Emergentes
17538.0,25,1,92.66,2,1,1,4,Clientes Churn
17540.0,24,2,544.9,3,1,2,6,Clientes Emergentes
17542.0,269,1,141.55,1,1,1,3,Clientes Churn
17545.0,42,3,413.58,2,2,2,6,Clientes Emergentes
17548.0,233,1,103.3,1,1,1,3,Clientes Churn
17549.0,23,2,16.439999999999998,3,1,1,5,Clientes Emergentes
17550.0,196,3,198.41,1,2,1,4,Clientes Churn
17551.0,358,1,298.34,1,1,2,4,Clientes Churn
17552.0,59,4,859.27,2,2,3,7,Clientes Emergentes
17554.0,0,5,1220.91,3,2,3,8,Clientes VIP
17555.0,19,2,474.76,3,1,2,6,Clientes Emergentes
17556.0,205,1,67.95,1,1,1,3,Clientes Churn
17557.0,13,3,525.01,3,2,2,7,Clientes Emergentes
17560.0,154,3,294.67,1,2,2,5,Clientes Emergentes
17561.0,18,1,140.0,3,1,1,5,Clientes Emergentes
17562.0,13,7,1078.82,3,3,3,9,Clientes VIP
17564.0,23,3,409.36,3,2,2,7,Clientes Emergentes
17566.0,7,2,796.81,3,1,2,6,Clientes Emergentes
17567.0,6,8,2775.57,3,3,3,9,Clientes VIP
17569.0,331,1,242.6,1,1,1,3,Clientes Churn
17571.0,49,3,1082.7,2,2,3,7,Clientes Emergentes
17572.0,70,4,206.85000000000002,2,2,1,5,Clientes Emergentes
17573.0,28,3,336.44,2,2,2,6,Clientes Emergentes
17574.0,242,1,155.8,1,1,1,3,Clientes Churn
17576.0,7,19,2765.9,3,3,3,9,Clientes VIP
17578.0,217,1,96.3,1,1,1,3,Clientes Churn
17579.0,4,3,427.65000000000003,3,2,2,7,Clientes Emergentes
17580.0,311,2,160.07,1,1,1,3,Clientes Churn
17581.0,0,24,7945.81,3,3,3,9,Clientes VIP
17582.0,235,1,99.37,1,1,1,3,Clientes Churn
17584.0,6,2,771.7,3,1,2,6,Clientes Emergentes
17585.0,108,4,833.16,1,2,3,6,Clientes Emergentes
17588.0,99,2,428.5,1,1,2,4,Clientes Churn
17589.0,59,4,2086.87,2,2,3,7,Clientes Emergentes
17590.0,1,3,1211.39,3,2,3,8,Clientes VIP
17591.0,72,7,1563.77,2,3,3,8,Clientes VIP
17593.0,3,5,3086.96,3,2,3,8,Clientes VIP
17594.0,84,2,993.18,2,1,3,6,Clientes Emergentes
17595.0,11,2,304.94,3,1,2,6,Clientes Emergentes
17596.0,22,7,1257.83,3,3,3,9,Clientes VIP
17597.0,213,1,1093.74,1,1,3,5,Clientes Emergentes
17600.0,17,1,115.68,3,1,1,5,Clientes Emergentes
17601.0,238,1,108.45,1,1,1,3,Clientes Churn
17602.0,1,6,4280.68,3,3,3,9,Clientes VIP
17603.0,77,1,144.72,2,1,1,4,Clientes Churn
17604.0,216,2,266.02,1,1,1,3,Clientes Churn
17608.0,32,2,193.42,2,1,1,4,Clientes Churn
17609.0,40,5,966.13,2,2,3,7,Clientes Emergentes
17611.0,6,15,3318.42,3,3,3,9,Clientes VIP
17612.0,52,6,1541.59,2,3,3,8,Clientes VIP
17613.0,22,14,3937.02,3,3,3,9,Clientes VIP
17614.0,56,1,350.47,2,1,2,5,Clientes Emergentes
17615.0,129,3,195.05,1,2,1,4,Clientes Churn
17618.0,5,3,685.93,3,2,2,7,Clientes Emergentes
17619.0,311,1,202.62,1,1,1,3,Clientes Churn
17620.0,59,1,47.44,2,1,1,4,Clientes Churn
17621.0,20,3,692.9,3,2,2,7,Clientes Emergentes
17623.0,32,1,455.45,2,1,2,5,Clientes Emergentes
17624.0,14,2,747.43,3,1,2,6,Clientes Emergentes
17625.0,17,4,1911.75,3,2,3,8,Clientes VIP
17628.0,80,1,75.75,2,1,1,4,Clientes Churn
17629.0,5,8,1467.32,3,3,3,9,Clientes VIP
17630.0,169,2,219.39999999999998,1,1,1,3,Clientes Churn
17631.0,1,3,445.29,3,2,2,7,Clientes Emergentes
17633.0,30,4,1243.34,2,2,3,7,Clientes Emergentes
17634.0,35,9,1592.27,2,3,3,8,Clientes VIP
17636.0,18,1,285.56,3,1,2,6,Clientes Emergentes
17637.0,30,2,464.51,2,1,2,5,Clientes Emergentes
17639.0,275,1,60.2,1,1,1,3,Clientes Churn
17640.0,86,1,114.3,2,1,1,4,Clientes Churn
17642.0,119,2,635.49,1,1,2,4,Clientes Churn
17643.0,372,1,58.8,1,1,1,3,Clientes Churn
17644.0,0,11,2287.71,3,3,3,9,Clientes VIP
17646.0,218,3,810.7900000000001,1,2,2,5,Clientes Emergentes
17647.0,64,1,82.11,2,1,1,4,Clientes Churn
17648.0,60,3,1224.6000000000001,2,2,3,7,Clientes Emergentes
17649.0,137,1,781.49,1,1,2,4,Clientes Churn
17650.0,20,1,166.08,3,1,1,5,Clientes Emergentes
17651.0,11,10,3623.63,3,3,3,9,Clientes VIP
17652.0,24,12,4274.92,3,3,3,9,Clientes VIP
17653.0,37,3,531.22,2,2,2,6,Clientes Emergentes
17654.0,276,1,80.65,1,1,1,3,Clientes Churn
17655.0,10,7,1342.44,3,3,3,9,Clientes VIP
17656.0,72,5,1177.25,2,2,3,7,Clientes Emergentes
17658.0,25,2,200.22,2,1,1,4,Clientes Churn
17659.0,16,12,2354.81,3,3,3,9,Clientes VIP
17660.0,140,1,186.05,1,1,1,3,Clientes Churn
17663.0,25,7,1542.3600000000001,2,3,3,8,Clientes VIP
17664.0,18,2,547.94,3,1,2,6,Clientes Emergentes
17666.0,3,2,110.58,3,1,1,5,Clientes Emergentes
17667.0,65,5,1708.07,2,2,3,7,Clientes Emergentes
17668.0,0,2,145.25,3,1,1,5,Clientes Emergentes
17669.0,42,7,880.52,2,3,3,8,Clientes VIP
17670.0,227,1,173.9,1,1,1,3,Clientes Churn
17671.0,15,4,1119.59,3,2,3,8,Clientes VIP
17672.0,49,2,2010.42,2,1,3,6,Clientes Emergentes
17673.0,1,6,1421.4,3,3,3,9,Clientes VIP
17674.0,73,2,271.32,2,1,1,4,Clientes Churn
17675.0,0,31,14162.95,3,3,3,9,Clientes VIP
17676.0,3,6,1308.1000000000001,3,3,3,9,Clientes VIP
17677.0,1,22,3524.49,3,3,3,9,Clientes VIP
17678.0,263,1,298.11,1,1,2,4,Clientes Churn
17679.0,52,2,892.86,2,1,3,6,Clientes Emergentes
17680.0,23,1,151.4,3,1,1,5,Clientes Emergentes
17682.0,9,6,2353.4900000000002,3,3,3,9,Clientes VIP
17684.0,43,1,201.01,2,1,1,4,Clientes Churn
17685.0,16,7,2535.26,3,3,3,9,Clientes VIP
17686.0,6,7,4067.48,3,3,3,9,Clientes VIP
17690.0,29,15,3287.92,2,3,3,8,Clientes VIP
17691.0,357,2,242.70000000000002,1,1,1,3,Clientes Churn
17692.0,126,4,611.04,1,2,2,5,Clientes Emergentes
17693.0,136,1,166.47,1,1,1,3,Clientes Churn
17694.0,141,1,251.92000000000002,1,1,1,3,Clientes Churn
17695.0,131,2,607.94,1,1,2,4,Clientes Churn
17696.0,37,8,1751.63,2,3,3,8,Clientes VIP
17697.0,235,1,298.25,1,1,2,4,Clientes Churn
17698.0,260,1,154.95,1,1,1,3,Clientes Churn
17700.0,16,4,2135.39,3,2,3,8,Clientes VIP
17701.0,252,1,193.65,1,1,1,3,Clientes Churn
17702.0,29,4,1016.99,2,2,3,7,Clientes Emergentes
17703.0,34,3,798.74,2,2,2,6,Clientes Emergentes
17704.0,168,2,729.99,1,1,2,4,Clientes Churn
17705.0,2,9,1511.72,3,3,3,9,Clientes VIP
17706.0,3,17,6826.93,3,3,3,9,Clientes VIP
17707.0,184,2,50.400000000000006,1,1,1,3,Clientes Churn
17708.0,187,2,258.58,1,1,1,3,Clientes Churn
17709.0,169,1,58.25,1,1,1,3,Clientes Churn
17711.0,10,2,369.8,3,1,2,6,Clientes Emergentes
17712.0,44,1,403.21,2,1,2,5,Clientes Emergentes
17714.0,320,1,153.0,1,1,1,3,Clientes Churn
17716.0,28,10,4455.29,2,3,3,8,Clientes VIP
17718.0,231,1,113.85,1,1,1,3,Clientes Churn
17719.0,37,15,3669.72,2,3,3,8,Clientes VIP
17720.0,25,4,860.54,2,2,3,7,Clientes Emergentes
17722.0,95,4,1560.26,1,2,3,6,Clientes Emergentes
17723.0,172,2,163.9,1,1,1,3,Clientes Churn
17724.0,70,3,820.2,2,2,2,6,Clientes Emergentes
17725.0,15,11,2946.2799999999997,3,3,3,9,Clientes VIP
17727.0,14,1,923.35,3,1,3,7,Clientes Emergentes
17728.0,3,3,2549.93,3,2,3,8,Clientes VIP
17730.0,2,13,3979.48,3,3,3,9,Clientes VIP
17731.0,78,4,871.06,2,2,3,7,Clientes Emergentes
17732.0,372,1,222.52,1,1,1,3,Clientes Churn
17733.0,38,2,471.63,2,1,2,5,Clientes Emergentes
17734.0,53,3,567.91,2,2,2,6,Clientes Emergentes
17735.0,1,19,12077.380000000001,3,3,3,9,Clientes VIP
17736.0,8,2,215.59,3,1,1,5,Clientes Emergentes
17737.0,8,2,137.64000000000001,3,1,1,5,Clientes Emergentes
17738.0,18,4,1351.81,3,2,3,8,Clientes VIP
17739.0,11,7,2131.35,3,3,3,9,Clientes VIP
17742.0,112,2,200.86,1,1,1,3,Clientes Churn
17744.0,3,6,1613.26,3,3,3,9,Clientes VIP
17746.0,239,1,74.8,1,1,1,3,Clientes Churn
17747.0,112,1,71.4,1,1,1,3,Clientes Churn
17749.0,177,2,478.95,1,1,2,4,Clientes Churn
17750.0,4,9,1176.62,3,3,3,9,Clientes VIP
17754.0,0,5,1090.16,3,2,3,8,Clientes VIP
17757.0,0,30,4312.15,3,3,3,9,Clientes VIP
17758.0,18,8,3130.05,3,3,3,9,Clientes VIP
17759.0,16,3,680.49,3,2,2,7,Clientes Emergentes
17760.0,21,2,218.25,3,1,1,5,Clientes Emergentes
17761.0,32,1,285.64,2,1,2,5,Clientes Emergentes
17763.0,262,1,15.0,1,1,1,3,Clientes Churn
17764.0,50,2,725.62,2,1,2,5,Clientes Emergentes
17765.0,158,3,263.83,1,2,1,4,Clientes Churn
17767.0,14,1,262.95,3,1,1,5,Clientes Emergentes
17768.0,7,3,1501.19,3,2,3,8,Clientes VIP
17769.0,12,10,3311.63,3,3,3,9,Clientes VIP
17770.0,198,3,286.57,1,2,2,5,Clientes Emergentes
17771.0,56,2,213.71,2,1,1,4,Clientes Churn
17772.0,10,2,134.32,3,1,1,5,Clientes Emergentes
17774.0,96,4,997.42,1,2,3,6,Clientes Emergentes
17775.0,254,1,56.4,1,1,1,3,Clientes Churn
17777.0,24,3,647.41,3,2,2,7,Clientes Emergentes
17779.0,20,3,494.86,3,2,2,7,Clientes Emergentes
17781.0,158,1,62.17,1,1,1,3,Clientes Churn
17783.0,71,2,274.97,2,1,1,4,Clientes Churn
17785.0,52,1,123.44,2,1,1,4,Clientes Churn
17786.0,84,2,238.67,2,1,1,4,Clientes Churn
17787.0,152,4,1677.94,1,2,3,6,Clientes Emergentes
17788.0,129,1,8.2,1,1,1,3,Clientes Churn
17789.0,280,1,191.65,1,1,1,3,Clientes Churn
17790.0,26,14,1653.5,2,3,3,8,Clientes VIP
17791.0,29,1,106.1,2,1,1,4,Clientes Churn
17793.0,24,1,172.32,3,1,1,5,Clientes Emergentes
17795.0,179,2,311.48,1,1,2,4,Clientes Churn
17796.0,39,4,585.95,2,2,2,6,Clientes Emergentes
17797.0,21,3,644.63,3,2,2,7,Clientes Emergentes
17799.0,21,10,2538.96,3,3,3,9,Clientes VIP
17800.0,36,9,964.16,2,3,3,8,Clientes VIP
17802.0,81,3,1145.07,2,2,3,7,Clientes Emergentes
17805.0,73,1,211.83,2,1,1,4,Clientes Churn
17806.0,10,1,445.11,3,1,2,6,Clientes Emergentes
17809.0,15,4,729.45,3,2,2,7,Clientes Emergentes
17811.0,3,39,5677.29,3,3,3,9,Clientes VIP
17812.0,12,4,579.61,3,2,2,7,Clientes Emergentes
17813.0,13,5,1221.03,3,2,3,8,Clientes VIP
17816.0,36,4,36.56,2,2,1,5,Clientes Emergentes
17817.0,3,2,114.43,3,1,1,5,Clientes Emergentes
17819.0,71,6,676.81,2,3,2,7,Clientes Emergentes
17824.0,50,1,235.84,2,1,1,4,Clientes Churn
17827.0,4,5,1759.49,3,2,3,8,Clientes VIP
17828.0,22,4,902.02,3,2,3,8,Clientes VIP
17829.0,298,1,765.34,1,1,2,4,Clientes Churn
17830.0,1,3,200.75,3,2,1,6,Clientes Emergentes
17831.0,32,1,35.400000000000006,2,1,1,4,Clientes Churn
17832.0,49,1,148.53,2,1,1,4,Clientes Churn
17835.0,2,3,287.94,3,2,2,7,Clientes Emergentes
17836.0,46,1,110.21000000000001,2,1,1,4,Clientes Churn
17837.0,41,8,1101.23,2,3,3,8,Clientes VIP
17838.0,26,5,1870.56,2,2,3,7,Clientes Emergentes
17839.0,41,1,338.8,2,1,2,5,Clientes Emergentes
17841.0,1,123,32644.72,3,3,3,9,Clientes VIP
17843.0,302,1,178.63,1,1,1,3,Clientes Churn
17844.0,106,1,51.559999999999995,1,1,1,3,Clientes Churn
17848.0,147,6,331.02,1,3,2,6,Clientes Emergentes
17849.0,263,3,64.60000000000001,1,2,1,4,Clientes Churn
17850.0,371,34,4462.16,1,3,3,7,Clientes Emergentes
17852.0,11,2,114.34,3,1,1,5,Clientes Emergentes
17854.0,184,2,120.01,1,1,1,3,Clientes Churn
17855.0,372,1,199.02,1,1,1,3,Clientes Churn
17856.0,232,2,131.0,1,1,1,3,Clientes Churn
17857.0,357,1,5.5,1,1,1,3,Clientes Churn
17858.0,5,9,2071.11,3,3,3,9,Clientes VIP
17859.0,304,1,124.81,1,1,1,3,Clientes Churn
17860.0,368,1,221.0,1,1,1,3,Clientes Churn
17861.0,2,8,1609.36,3,3,3,9,Clientes VIP
17862.0,323,1,260.0,1,1,1,3,Clientes Churn
17863.0,58,6,2891.44,2,3,3,8,Clientes VIP
17864.0,12,3,523.28,3,2,2,7,Clientes Emergentes
17865.0,30,18,6390.820000000001,2,3,3,8,Clientes VIP
17866.0,142,1,170.8,1,1,1,3,Clientes Churn
17867.0,29,3,240.77,2,2,1,5,Clientes Emergentes
17869.0,106,5,275.03,1,2,1,4,Clientes Churn
17870.0,1,11,1324.53,3,3,3,9,Clientes VIP
17871.0,204,1,131.42000000000002,1,1,1,3,Clientes Churn
17873.0,79,5,1083.46,2,2,3,7,Clientes Emergentes
17874.0,184,6,527.07,1,3,2,6,Clientes Emergentes
17877.0,169,1,158.01,1,1,1,3,Clientes Churn
17878.0,43,1,244.83,2,1,1,4,Clientes Churn
17879.0,173,1,154.67,1,1,1,3,Clientes Churn
17880.0,364,1,387.82,1,1,2,4,Clientes Churn
17881.0,303,1,133.35000000000002,1,1,1,3,Clientes Churn
17883.0,2,4,500.77,3,2,2,7,Clientes Emergentes
17884.0,3,4,559.6,3,2,2,7,Clientes Emergentes
17885.0,11,1,173.44,3,1,1,5,Clientes Emergentes
17886.0,31,3,498.56,2,2,2,6,Clientes Emergentes
17887.0,128,1,47.05,1,1,1,3,Clientes Churn
17888.0,59,6,402.47,2,3,2,7,Clientes Emergentes
17889.0,211,2,162.42,1,1,1,3,Clientes Churn
17890.0,322,2,523.77,1,1,2,4,Clientes Churn
17891.0,161,1,203.85999999999999,1,1,1,3,Clientes Churn
17892.0,56,2,121.1,2,1,1,4,Clientes Churn
17893.0,224,1,71.35000000000001,1,1,1,3,Clientes Churn
17894.0,71,8,905.76,2,3,3,8,Clientes VIP
17895.0,43,1,82.91,2,1,1,4,Clientes Churn
17897.0,172,3,405.35,1,2,2,5,Clientes Emergentes
17898.0,84,2,138.14,2,1,1,4,Clientes Churn
17899.0,158,1,95.59,1,1,1,3,Clientes Churn
17900.0,189,2,97.19999999999999,1,1,1,3,Clientes Churn
17901.0,28,1,41.78,2,1,1,4,Clientes Churn
17904.0,20,1,102.22,3,1,1,5,Clientes Emergentes
17905.0,156,3,339.84000000000003,1,2,2,5,Clientes Emergentes
17906.0,246,1,55.95,1,1,1,3,Clientes Churn
17908.0,373,1,229.45,1,1,1,3,Clientes Churn
17911.0,8,1,294.35,3,1,2,6,Clientes Emergentes
17912.0,309,5,195.13,1,2,1,4,Clientes Churn
17913.0,58,2,342.34,2,1,2,5,Clientes Emergentes
17914.0,3,1,237.75,3,1,1,5,Clientes Emergentes
17917.0,44,3,324.33,2,2,2,6,Clientes Emergentes
17919.0,87,1,615.48,2,1,2,5,Clientes Emergentes
17920.0,3,17,3472.12,3,3,3,9,Clientes VIP
17921.0,63,4,775.67,2,2,2,6,Clientes Emergentes
17924.0,11,4,703.38,3,2,2,7,Clientes Emergentes
17926.0,132,2,309.23,1,1,2,4,Clientes Churn
17928.0,44,2,155.56,2,1,1,4,Clientes Churn
17929.0,308,1,196.20000000000002,1,1,1,3,Clientes Churn
17930.0,35,5,707.4,2,2,2,6,Clientes Emergentes
17931.0,133,2,255.0,1,1,1,3,Clientes Churn
17932.0,28,3,1188.92,2,2,3,7,Clientes Emergentes
17934.0,58,1,307.68,2,1,2,5,Clientes Emergentes
17935.0,137,2,137.29,1,1,1,3,Clientes Churn
17936.0,4,1,337.24,3,1,2,6,Clientes Emergentes
17937.0,8,4,172.5,3,2,1,6,Clientes Emergentes
17939.0,159,1,99.14,1,1,1,3,Clientes Churn
17942.0,7,1,1.9,3,1,1,5,Clientes Emergentes
17946.0,232,2,79.78,1,1,1,3,Clientes Churn
17947.0,36,1,136.68,2,1,1,4,Clientes Churn
17949.0,7,4,258.29999999999995,3,2,1,6,Clientes Emergentes
17950.0,71,3,365.15,2,2,2,6,Clientes Emergentes
17951.0,39,3,208.38000000000002,2,2,1,5,Clientes Emergentes
17954.0,4,11,2036.16,3,3,3,9,Clientes VIP
17955.0,219,2,55.599999999999994,1,1,1,3,Clientes Churn
17957.0,65,1,96.25,2,1,1,4,Clientes Churn
17958.0,116,1,136.16,1,1,1,3,Clientes Churn
17960.0,170,1,73.78,1,1,1,3,Clientes Churn
17961.0,20,37,858.24,3,3,3,9,Clientes VIP
17962.0,141,1,82.44,1,1,1,3,Clientes Churn
17964.0,31,2,334.74,2,1,2,5,Clientes Emergentes
17965.0,37,14,2084.05,2,3,3,8,Clientes VIP
17966.0,150,2,155.43,1,1,1,3,Clientes Churn
17967.0,371,1,95.22,1,1,1,3,Clientes Churn
17968.0,373,1,269.4,1,1,1,3,Clientes Churn
17969.0,165,2,63.45,1,1,1,3,Clientes Churn
17970.0,210,1,299.13,1,1,2,4,Clientes Churn
17972.0,241,1,97.39,1,1,1,3,Clientes Churn
17973.0,51,1,299.48,2,1,2,5,Clientes Emergentes
17974.0,24,3,687.9,3,2,2,7,Clientes Emergentes
17975.0,14,13,3828.05,3,3,3,9,Clientes VIP
17976.0,371,1,314.04,1,1,2,4,Clientes Churn
17977.0,28,1,95.29,2,1,1,4,Clientes Churn
17978.0,364,1,129.5,1,1,1,3,Clientes Churn
17979.0,35,4,601.73,2,2,2,6,Clientes Emergentes
17980.0,165,3,228.15,1,2,1,4,Clientes Churn
17984.0,144,1,131.68,1,1,1,3,Clientes Churn
17985.0,21,1,574.95,3,1,2,6,Clientes Emergentes
17986.0,55,1,20.8,2,1,1,4,Clientes Churn
17987.0,184,1,123.92999999999999,1,1,1,3,Clientes Churn
17988.0,11,7,99.92,3,3,1,7,Clientes Emergentes
17990.0,236,3,585.84,1,2,2,5,Clientes Emergentes
17991.0,224,2,67.85,1,1,1,3,Clientes Churn
17994.0,121,4,549.43,1,2,2,5,Clientes Emergentes
17995.0,281,1,23.6,1,1,1,3,Clientes Churn
17997.0,73,8,1272.31,2,3,3,8,Clientes VIP
17999.0,36,2,336.46,2,1,2,5,Clientes Emergentes
18001.0,11,2,275.03000000000003,3,1,1,5,Clientes Emergentes
18004.0,361,1,115.97,1,1,1,3,Clientes Churn
18005.0,3,2,186.27,3,1,1,5,Clientes Emergentes
18006.0,22,1,251.53000000000003,3,1,1,5,Clientes Emergentes
18008.0,69,4,71.53,2,2,1,5,Clientes Emergentes
18009.0,234,1,182.29,1,1,1,3,Clientes Churn
18010.0,256,1,61.6,1,1,1,3,Clientes Churn
18011.0,372,1,92.84,1,1,1,3,Clientes Churn
18013.0,154,2,129.81,1,1,1,3,Clientes Churn
18014.0,27,1,150.52,2,1,1,4,Clientes Churn
18015.0,3,1,120.03,3,1,1,5,Clientes Emergentes
18016.0,31,5,955.5,2,2,3,7,Clientes Emergentes
18018.0,107,2,53.589999999999996,1,1,1,3,Clientes Churn
18019.0,51,1,28.5,2,1,1,4,Clientes Churn
18022.0,35,1,597.64,2,1,2,5,Clientes Emergentes
18024.0,152,1,67.63,1,1,1,3,Clientes Churn
18027.0,98,1,115.31,1,1,1,3,Clientes Churn
18030.0,3,2,35.45,3,1,1,5,Clientes Emergentes
18032.0,333,1,73.5,1,1,1,3,Clientes Churn
18033.0,64,1,75.97,2,1,1,4,Clientes Churn
18034.0,21,2,347.04,3,1,2,6,Clientes Emergentes
18035.0,35,3,257.44,2,2,1,5,Clientes Emergentes
18036.0,31,3,405.62,2,2,2,6,Clientes Emergentes
18037.0,153,6,33.17,1,3,1,5,Clientes Emergentes
18040.0,18,2,340.20000000000005,3,1,2,6,Clientes Emergentes
18041.0,11,21,2982.09,3,3,3,9,Clientes VIP
18042.0,53,1,93.35,2,1,1,4,Clientes Churn
18043.0,24,3,456.81,3,2,2,7,Clientes Emergentes
18044.0,3,10,1388.7,3,3,3,9,Clientes VIP
18045.0,44,1,156.15,2,1,1,4,Clientes Churn
18048.0,202,2,95.97,1,1,1,3,Clientes Churn
18050.0,358,1,74.4,1,1,1,3,Clientes Churn
18053.0,70,1,283.02,2,1,2,5,Clientes Emergentes
18055.0,6,10,5429.66,3,3,3,9,Clientes VIP
18056.0,287,1,293.7,1,1,2,4,Clientes Churn
18058.0,9,1,6.959999999999999,3,1,1,5,Clientes Emergentes
18059.0,22,3,290.56,3,2,2,7,Clientes Emergentes
18061.0,21,10,1053.39,3,3,3,9,Clientes VIP
18062.0,172,3,282.45,1,2,2,5,Clientes Emergentes
18064.0,132,1,48.0,1,1,1,3,Clientes Churn
18065.0,5,14,1803.16,3,3,3,9,Clientes VIP
18066.0,74,1,318.0,2,1,2,5,Clientes Emergentes
18067.0,39,1,319.03,2,1,2,5,Clientes Emergentes
18069.0,25,5,1879.85,2,2,3,7,Clientes Emergentes
18071.0,257,2,369.4,1,1,2,4,Clientes Churn
18072.0,185,1,247.44,1,1,1,3,Clientes Churn
18073.0,113,11,725.3000000000001,1,3,2,6,Clientes Emergentes
18074.0,373,1,185.3,1,1,1,3,Clientes Churn
18075.0,22,10,2141.4900000000002,3,3,3,9,Clientes VIP
18077.0,7,11,2453.55,3,3,3,9,Clientes VIP
18078.0,216,2,185.98,1,1,1,3,Clientes Churn
18079.0,44,3,610.51,2,2,2,6,Clientes Emergentes
18081.0,35,3,290.58000000000004,2,2,2,6,Clientes Emergentes
18082.0,25,1,585.41,2,1,2,5,Clientes Emergentes
18085.0,329,2,689.95,1,1,2,4,Clientes Churn
18086.0,273,1,101.34,1,1,1,3,Clientes Churn
18088.0,60,1,133.67000000000002,2,1,1,4,Clientes Churn
18092.0,1,9,2818.12,3,3,3,9,Clientes VIP
18093.0,119,2,398.59999999999997,1,1,2,4,Clientes Churn
18094.0,81,6,1705.46,2,3,3,8,Clientes VIP
18095.0,312,2,283.8,1,1,2,4,Clientes Churn
18096.0,11,3,766.73,3,2,2,7,Clientes Emergentes
18097.0,7,6,2013.3400000000001,3,3,3,9,Clientes VIP
18099.0,126,1,160.35999999999999,1,1,1,3,Clientes Churn
18101.0,10,2,163.95,3,1,1,5,Clientes Emergentes
18102.0,0,13,5344.04,3,3,3,9,Clientes VIP
18104.0,36,1,424.64,2,1,2,5,Clientes Emergentes
18105.0,37,1,103.53,2,1,1,4,Clientes Churn
18106.0,329,1,196.9,1,1,1,3,Clientes Churn
18108.0,253,1,201.2,1,1,1,3,Clientes Churn
18109.0,1,26,3479.07,3,3,3,9,Clientes VIP
18110.0,19,1,218.4,3,1,1,5,Clientes Emergentes
18112.0,11,2,198.52,3,1,1,5,Clientes Emergentes
18114.0,289,1,137.9,1,1,1,3,Clientes Churn
18116.0,67,8,1099.07,2,3,3,8,Clientes VIP
18117.0,25,1,225.74,2,1,1,4,Clientes Churn
18118.0,10,26,4672.75,3,3,3,9,Clientes VIP
18119.0,367,1,140.51,1,1,1,3,Clientes Churn
18120.0,213,1,75.35,1,1,1,3,Clientes Churn
18121.0,148,2,635.6,1,1,2,4,Clientes Churn
18122.0,7,6,1642.77,3,3,3,9,Clientes VIP
18123.0,23,2,389.16,3,1,2,6,Clientes Emergentes
18125.0,29,4,1035.31,2,2,3,7,Clientes Emergentes
18126.0,60,1,198.57999999999998,2,1,1,4,Clientes Churn
18127.0,18,3,258.74,3,2,1,6,Clientes Emergentes
18129.0,242,1,99.80000000000001,1,1,1,3,Clientes Churn
18130.0,14,3,941.16,3,2,3,8,Clientes VIP
18135.0,28,4,206.25,2,2,1,5,Clientes Emergentes
18136.0,62,3,767.33,2,2,2,6,Clientes Emergentes
18138.0,294,1,67.80000000000001,1,1,1,3,Clientes Churn
18139.0,17,6,3112.86,3,3,3,9,Clientes VIP
18142.0,215,1,134.4,1,1,1,3,Clientes Churn
18143.0,116,2,895.8100000000001,1,1,3,5,Clientes Emergentes
18144.0,30,11,912.1500000000001,2,3,3,8,Clientes VIP
18145.0,12,4,2761.12,3,2,3,8,Clientes VIP
18146.0,140,2,160.35000000000002,1,1,1,3,Clientes Churn
18147.0,45,2,147.83999999999997,2,1,1,4,Clientes Churn
18149.0,50,3,323.7,2,2,2,6,Clientes Emergentes
18150.0,31,3,566.58,2,2,2,6,Clientes Emergentes
18151.0,134,2,560.7,1,1,2,4,Clientes Churn
18154.0,2,2,360.94,3,1,2,6,Clientes Emergentes
18155.0,74,3,351.46,2,2,2,6,Clientes Emergentes
18156.0,12,2,698.49,3,1,2,6,Clientes Emergentes
18158.0,8,2,453.4,3,1,2,6,Clientes Emergentes
18159.0,300,1,257.25,1,1,1,3,Clientes Churn
18160.0,56,2,499.06,2,1,2,5,Clientes Emergentes
18161.0,14,5,1281.32,3,2,3,8,Clientes VIP
18164.0,36,1,337.40000000000003,2,1,2,5,Clientes Emergentes
18165.0,176,1,177.66,1,1,1,3,Clientes Churn
18167.0,22,3,1259.46,3,2,3,8,Clientes VIP
18168.0,175,6,863.68,1,3,3,7,Clientes Emergentes
18169.0,60,1,151.65,2,1,1,4,Clientes Churn
18170.0,32,3,490.51,2,2,2,6,Clientes Emergentes
18171.0,58,5,675.6800000000001,2,2,2,6,Clientes Emergentes
18172.0,30,15,4039.5,2,3,3,8,Clientes VIP
18173.0,86,4,884.98,2,2,3,7,Clientes Emergentes
18176.0,357,1,419.05,1,1,2,4,Clientes Churn
18177.0,30,6,1279.02,2,3,3,8,Clientes VIP
18178.0,128,4,1521.22,1,2,3,6,Clientes Emergentes
18179.0,8,5,1233.24,3,2,3,8,Clientes VIP
18180.0,4,6,1637.38,3,3,3,9,Clientes VIP
18181.0,23,1,340.35,3,1,2,6,Clientes Emergentes
18183.0,226,2,512.87,1,1,2,4,Clientes Churn
18185.0,248,1,214.25,1,1,1,3,Clientes Churn
18188.0,14,3,1344.72,3,2,3,8,Clientes VIP
18189.0,77,2,891.34,2,1,3,6,Clientes Emergentes
18190.0,191,2,219.16000000000003,1,1,1,3,Clientes Churn
18191.0,261,1,37.4,1,1,1,3,Clientes Churn
18192.0,71,1,698.82,2,1,2,5,Clientes Emergentes
18193.0,164,1,208.91,1,1,1,3,Clientes Churn
18196.0,94,2,588.43,1,1,2,4,Clientes Churn
18198.0,3,16,2018.14,3,3,3,9,Clientes VIP
18200.0,105,1,163.8,1,1,1,3,Clientes Churn
18202.0,199,3,1058.99,1,2,3,6,Clientes Emergentes
18203.0,156,1,126.07,1,1,1,3,Clientes Churn
18204.0,70,3,1673.55,2,2,3,7,Clientes Emergentes
18205.0,35,2,408.86,2,1,2,5,Clientes Emergentes
18209.0,28,1,139.10000000000002,2,1,1,4,Clientes Churn
18210.0,1,6,1907.18,3,3,3,9,Clientes VIP
18211.0,25,5,515.0699999999999,2,2,2,6,Clientes Emergentes
18212.0,325,1,207.82,1,1,1,3,Clientes Churn
18213.0,236,1,232.48000000000002,1,1,1,3,Clientes Churn
18215.0,88,1,266.34000000000003,2,1,1,4,Clientes Churn
18216.0,30,1,360.85,2,1,2,5,Clientes Emergentes
18217.0,28,2,515.67,2,1,2,5,Clientes Emergentes
18218.0,210,2,299.0,1,1,2,4,Clientes Churn
18219.0,2,10,1616.92,3,3,3,9,Clientes VIP
18221.0,21,5,913.82,3,2,3,8,Clientes VIP
18222.0,92,1,333.87,1,1,2,4,Clientes Churn
18223.0,4,14,5481.32,3,3,3,9,Clientes VIP
18224.0,263,1,158.95000000000002,1,1,1,3,Clientes Churn
18225.0,2,12,4248.51,3,3,3,9,Clientes VIP
18226.0,43,11,4400.21,2,3,3,8,Clientes VIP
18227.0,217,1,30.0,1,1,1,3,Clientes Churn
18228.0,56,2,760.0,2,1,2,5,Clientes Emergentes
18229.0,11,20,3664.7,3,3,3,9,Clientes VIP
18230.0,8,7,2032.9,3,3,3,9,Clientes VIP
18231.0,191,5,1492.02,1,2,3,6,Clientes Emergentes
18232.0,81,4,533.57,2,2,2,6,Clientes Emergentes
18235.0,71,3,1477.78,2,2,3,7,Clientes Emergentes
18236.0,29,6,818.64,2,3,2,7,Clientes Emergentes
18237.0,2,5,819.5699999999999,3,2,2,7,Clientes Emergentes
18239.0,218,5,1457.81,1,2,3,6,Clientes Emergentes
18240.0,45,1,125.58000000000001,2,1,1,4,Clientes Churn
18241.0,9,17,1786.64,3,3,3,9,Clientes VIP
18242.0,71,4,1629.92,2,2,3,7,Clientes Emergentes
18245.0,6,7,2266.43,3,3,3,9,Clientes VIP
18246.0,232,1,29.5,1,1,1,3,Clientes Churn
18248.0,122,2,599.84,1,1,2,4,Clientes Churn
18249.0,16,1,81.66,3,1,1,5,Clientes Emergentes
18250.0,309,1,270.62,1,1,1,3,Clientes Churn
18252.0,50,2,385.67,2,1,2,5,Clientes Emergentes
18255.0,88,1,103.3,2,1,1,4,Clientes Churn
18257.0,38,8,2012.26,2,3,3,8,Clientes VIP
18259.0,24,3,2203.6000000000004,3,2,3,8,Clientes VIP
18260.0,172,6,2127.31,1,3,3,7,Clientes Emergentes
18261.0,42,2,314.29,2,1,2,5,Clientes Emergentes
18262.0,139,1,149.48,1,1,1,3,Clientes Churn
18263.0,25,3,1042.4,2,2,3,7,Clientes Emergentes
18265.0,71,2,609.11,2,1,2,5,Clientes Emergentes
18269.0,365,1,168.6,1,1,1,3,Clientes Churn
18270.0,37,2,244.9,2,1,1,4,Clientes Churn
18272.0,2,6,2794.96,3,3,3,9,Clientes VIP
18273.0,1,2,102.0,3,1,1,5,Clientes Emergentes
18274.0,29,1,163.17,2,1,1,4,Clientes Churn
18276.0,43,1,213.46,2,1,1,4,Clientes Churn
18277.0,57,1,110.38,2,1,1,4,Clientes Churn
18278.0,73,1,173.9,2,1,1,4,Clientes Churn
18280.0,277,1,137.0,1,1,1,3,Clientes Churn
18281.0,180,1,46.92,1,1,1,3,Clientes Churn
18282.0,7,2,113.13000000000001,3,1,1,5,Clientes Emergentes
18283.0,3,16,2051.98,3,3,3,9,Clientes VIP
18287.0,42,3,960.76,2,2,3,7,Clientes Emergentes
